алексушин: алексушин
алён: алёна
анализ: анализ, анализе
анализируются: анализируются
аннотация: аннотация
аратюнян: аратюнян
аудитори: аудитории
боле: более
больш: большей, большой
бурлак: бурлаков
был: был, были
важн: важным
важну: важную
вел: вело
взаимозависиму: взаимозависимую
взаимосвязанну: взаимосвязанную
видел: видела
видят: видят
вклад: вклад
владимирович: владимирович
власт: власти
влияни: влияние
влияния: влияния
внедрит: внедрить
внесл: внесло
внеш: внешней
внешн: внешних
внешняя: внешняя
внутр: внутри
внутрен: внутренней
внутренн: внутренних
внутренним: внутренними
возможн: возможным
возможност: возможность
вопрос: вопрос, вопросов
время: время
все: все
всег: всего
всеобъемлющ: всеобъемлюще
выдвигают: выдвигают
выделит: выделить
вызвавш: вызвавших
вызвал: вызвало
вызов: вызовами
гагик: гагик
где: где
главн: главным
гладк: гладков
гласност: гласности, гласность
глеб: глеб
глобализация: глобализация
глубок: глубокой
год: года, годам, годов, годы
годах: годах
горбач: горбачев
горбачев: горбачева, горбачевым
государств: государства
государственн: государственный, государственных
граждан: граждан
дальнейш: дальнейшего
данн: данная, данной
движени: движение
действовал: действовали
делал: делали
дестабилизаци: дестабилизацию
дестабилизация: дестабилизация
дискусси: дискуссии
диссидент: диссидентское
дмитриевн: дмитриевна
до: до
дон: дону
доступ: доступ
доступн: доступными
доход: доходов, доходы
доцент: доцент
други: другие
его: его
един: единой
единств: единство
единственну: единственную
ее: ее
екатеринбург: екатеринбург
елисеев: елисеева
её: её
жестк: жесткая
жизн: жизни
жизнь: жизнью
заключени: заключение
закрыты: закрытые
запад: запада, западного
зарубежн: зарубежных
защит: защиты
значительн: значительной
значительны: значительные
золотарёв: золотарёв
зрения: зрения
играл: играли
играют: играют
идентичност: идентичности
из: из
изменен: изменениями
изменени: изменение
изменения: изменения
имениты: именитые
именн: именно
имеющи: имеющий
инициированн: инициированная, инициированных
интерпретаци: интерпретации
информаци: информации
информационн: информационный
исследовани: исследовании
исследовател: исследователи
ист: ист
истори: истории
историче: исторический
их: их
казан: казань
как: как
калашник: калашников
карабах: карабахский
катализатор: катализатором
качеств: качества
ключеву: ключевую
ключевы: ключевые
когд: когда
конечн: конечно, конечном
консенсус: консенсуса
контроля: контроля
конфликт: конфликтов
конц: конце
коррупци: коррупции
котор: которая, которое, котором, который
которы: которые
кпсс: кпсс
крах: краха
кризис: кризис, кризиса, кризисы
кузин: кузина
кузнец: кузнецов
культурны: культурные
курс: курса
ланц: ланцов
левченк: левченко
легитимност: легитимности
лет: лет
либерализация: либерализация
лини: линии
литератур: литературе, литературы
лиш: лишь
лишил: лишило
лояльност: лояльности
любу: любую
мальц: мальцев
массов: массового
межд: между
межэтниче: межэтнических
мене: менее
михаил: михаилом
михе: михеев
мнени: мнение, мнению
мног: многих
многи: многие
многогранн: многогранным, многогранными
можн: можно
молодеж: молодежи
монополи: монополии
москв: москва
мощн: мощной
нагорн: нагорно
над: над
например: например
напряженност: напряженности
населени: население
населения: населения
настольк: настолько
наук: наук
научн: научной, научный
нацелен: нацелена
национализм: национализма
национальн: национальной, национальный, национальным
национальны: национальные
начавшаяся: начавшаяся
начал: начали
недовольств: недовольства, недовольство, недовольству
недостаток: недостаток
недостаточн: недостаточно
независимост: независимости
независимы: независимые
неизбежн: неизбежный
некоторы: некоторые
необходим: необходимо, необходимыми
нерациональн: нерациональному
неспособен: неспособен
неспособност: неспособности
нестабильност: нестабильность
нефт: нефть
нефтян: нефтяных
нехватк: нехватке
неэффективн: неэффективной
неэффективност: неэффективность
нов: новой
новосибирск: новосибирск
обветшани: обветшание
обобщени: обобщение
обострени: обострение
образ: образа, образом
обход: обход
обществ: общества
общественн: общественное, общественной, общественному, общественных
общественны: общественные
общу: общую
объяснения: объяснения
объяснял: объясняла
одн: одни
однак: однако
одним: одним
однознач: однозначного
ожидани: ожиданий
оказался: оказался
они: они
опираяс: опираясь
определял: определяли
ослаблени: ослаблению
особенн: особенно
особенност: особенности
осознат: осознать
от: от
отдельн: отдельных
отметит: отметить
отмечает: отмечает
отмечается: отмечается
отрасл: отраслей
отсутстви: отсутствие
очеред: очередь
ошибках: ошибках
ощущал: ощущало
падени: падение
партий: партийного
партийн: партийной
перв: первый
переплетения: переплетения
перестройк: перестройка, перестройки
переход: переход
период: период
петербург: петербург
план: план
планировани: планирование
планов: плановой
плюрализм: плюрализма
поддержания: поддержания
подробн: подробно
подрывал: подрывал
подтверждает: подтверждает
подход: подходов
подчеркивает: подчеркивает
подчеркивается: подчеркивается
позволил: позволил
политик: политика, политики
политиче: политическая, политических
политическ: политического, политической
политически: политические
помим: помимо
популяризация: популяризация
попытк: попытка
пор: пор
поскольк: поскольку
последни: последние
последствия: последствия
постепенн: постепенное
постсоветски: постсоветские
поступавши: поступавшие
потребитель: потребительских
правительств: правительство, правительством
предопределен: предопределен
предпосылках: предпосылках
предприяти: предприятий
прежд: прежде
приведши: приведшие
привел: привел, привела, привели, привело
причин: причин, причину, причины
причинах: причинах
проблем: проблемы
проблемах: проблемах
проводит: проводить
продолжаются: продолжаются
продуманн: продуманной
произошл: произошли
противореч: противоречиями
проф: проф
профессор: профессор
процесс: процесс, процессе, процессом
проявилас: проявилась
публикаци: публикации
публицист: публицисты
работ: работе
развал: развал, развала, развале
развития: развития
различия: различия
различн: различных
различны: различные
разрушени: разрушение
ране: ранее
распад: распад, распада, распаде, распаду
распределени: распределению
рассмотренны: рассмотренные
рафаэл: рафаэль
регион: регионам
режим: режиму
резк: резкое
результат: результате, результатом
резюмируя: резюмируя
республик: республикам, республики
ресурс: ресурсов
реформ: реформ, реформа, реформу, реформы
рол: роль
росси: россии
россий: российских
рост: рост, ростов, росту
руководител: руководители, руководитель
руководств: руководства, руководство
рф: рф
рыночн: рыночной
ряд: ряда, ряду
самар: самара, самарский
самоопределения: самоопределения
самостоятельн: самостоятельной
санкт: санкт
саттар: саттаров
сво: своей, свою
связ: связи
сделал: сделали
симон: симонов
систем: системой, системы
ситуаци: ситуацию
ситуация: ситуация
сих: сих
сказат: сказать
скрывалис: скрывались
слабост: слабость
следует: следует
слов: слова
слож: сложного
сложн: сложный, сложными
сми: сми
смогл: смогло
снижени: снижение, снижению
собственност: собственности
события: события
совет: советский, советское
советск: советского, советской, советскому
совокупност: совокупности
современност: современности
согласн: согласны
создал: создали
создани: созданию
сопровождалис: сопровождались
социальн: социально, социальной, социальных
социальны: социальные
союз: союз, союза
список: список
способствовал: способствовали
справиться: справиться
сред: среди
средств: средств
ссср: ссср
стабильн: стабильно
стабильност: стабильности
ставши: ставший
стал: стало
стать: статье
статья: статья
степен: степени, степень
странах: странах
структурн: структурными
студент: студент
субсидирования: субсидирования
существенн: существенно, существенному
существования: существования
существует: существует
существуют: существуют
счет: счете
считают: считают
сыграл: сыграли
так: таких
таки: такие
таким: таким
тенев: теневой
товар: товаров
том: тому
тот: тот
точк: точки, точкой
требоват: требовать
треть: третьи
тридцат: тридцати
труд: труды
трудн: трудно
трудност: трудностей
тура: тураев
уже: уже
узнал: узнало
указани: указаний
указывает: указывает
указывают: указывают
уменьшил: уменьшило
университет: университет
уровня: уровня
урок: уроки
ускорил: ускорили
успешны: успешные
усугубил: усугубили
утверждает: утверждает
утверждают: утверждают
уфа: уфа
учен: ученых
фактор: фактор, факторов, фактором, факторы
фельдман: фельдман
финансов: финансовых
фокусируются: фокусируются
фон: фоне
цен: цен
ценност: ценностей
централизация: централизация
центральн: центральное, центральным, центральных
частн: частной
частност: частности
челябинск: челябинск
читателя: читателя
что: что
широк: широкой
шориков: шорикова
экономик: экономика, экономики
экономиче: экономическая, экономический, экономических
экономическ: экономической
экономически: экономические
экономическу: экономическую
экспорт: экспорта
элемент: элементам, элементы
энергетическ: энергетического
энергоресурс: энергоресурсов
этим: этим, этими
этих: этих
это: это
этот: этот
эффективн: эффективно, эффективным
является: является
