автоматизаци: автоматизации
автор: автором
адмирал: адмирала
азов: азов
александрийску: александрийскую
александринск: александринского
алексеевн: алексеевна
алтайск: алтайского
аннотация: аннотация
апрел: апреле
артерия: артерия
аэс: аэс
бассейн: бассейна
белгородск: белгородского
больш: большая, больше, большое
большу: большую
борзенц: борзенцов
был: был, было
важн: важное
важнейш: важнейшая
важнейшим: важнейшим
вакуленк: вакуленко
вв: вв
ввозил: ввозили
ведомост: ведомости
век: века, веке
веках: веках
вин: вино
вод: воды
водн: водная, водных
водохранилищ: водохранилища, водохранилищем
водя: водяного
военн: военная
возник: возник
вопрос: вопросами
воронеж: воронежа
вот: вот
времен: времени
время: время
всег: всего
всех: всех
втор: второй
вывозил: вывозили
вывозит: вывозить
выделил: выделил
выделял: выделяли
гг: гг
географиче: географическое
главн: главный
главну: главную
глушков: глушково
год: года, годов, году, годы
город: городов, городом
государствен: государственного
государственн: государственный
груз: грузом
грузов: грузовой, грузовых
грузовы: грузовые
губернатор: губернаторы
губерни: губернии
губернск: губернского
да: да
дальнейше: дальнейшее
дарья: дарья
движени: движение
движения: движения
дворян: дворяне
двух: двух
денег: денег
десн: десны
длин: длина, длиной, длины
дне: дне
до: до
договор: договорам
должн: должно
дон: дон
дорожн: дорожной
доск: доски
достаточн: достаточно
достигают: достигают
древн: древнего
европ: европе
его: его
еди: единого
ее: ее
ещё: ещё
желез: железо
жертвовал: жертвовали
жизн: жизнь
журнал: журнал
зависел: зависело
заканчивалос: заканчивалось
заключенн: заключенным
закупк: закупку
заметн: заметно
записк: записки
заря: заря
затруднял: затрудняло
защит: защиты
здани: зданий
зерн: зерно
значени: значение
играет: играет
играл: играло
из: из
избежат: избежать
известия: известия
извилист: извилиста
изначальн: изначально
имел: имела
имен: имени
именн: именно
император: императором
инженерн: инженерным
использовал: использовали
использовалис: использовались
использовался: использовался
используя: используя
история: история
их: их
казн: казне, казны
как: как
канкрин: канкриным
катер: катеров
кафедр: кафедра
кв: кв
ключевы: ключевые
км: км
книгах: книгах
князя: князя
когд: когда
кож: кожу
козл: козли
количеств: количество
комитет: комитета, комитету
конц: конца, конце
корабл: кораблей
коряг: коряг
котор: которой, которыми, которых
крепост: крепости
круп: крупного
крупн: крупных
крупны: крупные
крым: крымских
купц: купцов, купцы
курск: курска, курске, курского, курской, курском
курски: курские
ладь: ладьи
лес: лес
литератур: литературы
личн: лично
лиш: лишь
льгов: льгова, льгове
льговск: льговского
людинов: людиново
лёд: лёд
магистрант: магистрант
макаров: макарова
масл: масло
материал: материала
материалах: материалах
мая: мая
мелк: мелких
менял: меняла
мест: местами
местны: местные
министр: министром
мног: многом
множеств: множество
мор: морю
морск: морского
мук: муку
набег: набегов
наем: наем
наличи: наличие
научн: научный
научны: научные
находилос: находилось
начал: начала
начиналос: начиналось
невозможн: невозможным
некотор: некоторыми
некоторы: некоторые
немаловажну: немаловажную
необходим: необходимых
неправильн: неправильная
непредусмотренн: непредусмотренных
неравномерн: неравномерно
несмотря: несмотря
никола: николаем
них: них
ногай: ногайских
обещания: обещания
област: области
обмелел: обмелела
оборонительны: оборонительные
обратн: обратно
обустройств: обустройству
объективны: объективные
однак: однако
одобрен: одобрен
окол: около
октябр: октябре
они: они
описан: описаны
организовал: организовали
орл: орла
осень: осенью
оставалос: оставалось
остальны: остальные
останавливалис: останавливались
осуществлялос: осуществлялось
от: от
открыл: открыли
отмел: отмелей
отражалис: отражались
отрезк: отрезке
отсутстви: отсутствие
официальн: официально
оценк: оценка
паров: паровых
пароход: пароход
пассажирск: пассажирского
пассажирски: пассажирские
пеньк: пеньку
перв: первая, первых
перевод: переводов
переквалифицируются: переквалифицируются
петербург: петербург
план: план, плана
площад: площадь
повлиял: повлияла
погодн: погодными
под: под
подданн: подданный
подрядчик: подрядчиками
позволил: позволили
политология: политология
половин: половине
помещик: помещик
порт: порт, портов
поселени: поселений
поселения: поселения
посл: после
последне: последнее
последни: последний
поставщик: поставщика
построен: построено
построил: построил
постройк: постройку
поэт: поэтому
появлени: появление
практическ: практически
прекращалос: прекращалось
прекращен: прекращено
преобразовани: преобразованием
при: при
прибыл: прибыл
приведени: приведению
приведения: приведения
привел: привело
признат: признать
пример: примере
приста: пристаней
пристан: пристань
приток: приток
приходилос: приходилось
приходн: приходно
прич: причем
причин: причины
пришлос: пришлось
пробл: проблем
прогулочн: прогулочных
проект: проект, проекта
происходил: происходила
происходит: происходит
прославился: прославился
просуществовал: просуществовало
проходил: проходило
процесс: процессе
прошел: прошел
пузан: пузанов
пузанов: пузанова
пут: путей, пути, путь
работ: работ, работы
рабоч: рабочей
развити: развитие, развитии
район: районе
раньш: раньше
расположени: расположение
рассчитан: рассчитаны
расход: расходов
расходн: расходных
реализаци: реализации
реализовывался: реализовывался
регион: регион, региона, регионе, регионов
резк: резкому
рек: рек, река, реке, реки, реку
ремесленны: ремесленные
реч: речного
речн: речной
рол: роль
рост: росте
рубл: рублей
русл: русло
русск: русского
рф: рф
рыльск: рыльска, рыльске
ряд: ряд, рядом
самы: самые
санкт: санкт
сахар: сахаров
сво: свое
связан: связано
связанн: связанно, связанных
связанны: связанные
сделал: сделал, сделало
сезон: сезон
сезонность: сезонностью
сейм: сейм, сейма, сейме, сейму
серия: серия
сет: сети
сил: силы
систем: системой, системы
следовавши: следовавшие
следует: следует
слов: слова
снижени: снижению
снимается: снимается
собственн: собственных
событи: событием
совершенствования: совершенствования
советски: советские
советску: советскую
сообщения: сообщения
сооружени: сооружений
соседни: соседние
состояни: состояние
состояния: состояния
социальн: социально
специализация: специализация
список: список
сплавил: сплавил
сраз: сразу
средн: среднем
средств: средств, средства
стал: стал
сталкивалос: сталкивалось
становившихся: становившихся
стать: статье
стекл: стекло
столкнуться: столкнуться
стратегиче: стратегическое
строитель: строительного
строительн: строительных
строительств: строительства, строительство, строительству
суд: суда, судов
судн: судно
судоходн: судоходная, судоходное, судоходной
судоходств: судоходства, судоходство
сходил: сходил
считалос: считалось
татар: татар
теплоход: теплоходы
территори: территории
техниче: технических
технологи: технологии
товар: товар, товаром
товариществ: товарищество
тольк: только
том: том
торгов: торгово, торгового
торговл: торговли
транспорт: транспорт, транспорта
транспортн: транспортный
трат: трата
тратилис: тратились
три: три
трубецк: трубецкого
трудност: трудностей, трудностями
тускар: тускарь
тыс: тыс
тысяч: тысяч
уезд: уезда
уже: уже
университет: университет, университета
уровня: уровня
услов: условиями
усложнял: усложняло
участк: участки
участок: участок
учены: ученые
финанс: финансов
финансирования: финансирования
финансов: финансовых
флот: флота
фонд: фонда
функционировани: функционирование
хiх: хiх
хviii: хviii
хватит: хватить
ходивш: ходивших
ходил: ходили
хозяйственн: хозяйственная
царств: царства
цел: целом, целый
централь: центрального
част: часть
часть: частью
чег: чего
через: через
черн: черному
черноземья: черноземья
числ: числе
что: что
чут: чуть
ширин: шириной
шли: шли
шлюз: шлюз, шлюзов, шлюзы
шлюзн: шлюзной
шпак: шпаков
щигров: щигровский
экономик: экономики
экономиче: экономическое
экономическ: экономическом
эксплуатаци: эксплуатации
электронн: электронный
эпох: эпоху
этап: этапы
это: это
этом: этом
являлас: являлась
являлис: являлись
