автор: автором
акад: акад
акш: акша
акшинск: акшинского
алтай: алтайский
аннотация: аннотация
арестант: арестантов
аспект: аспекты
аспирант: аспирант
афанась: афанасьев
барнаул: барнаул
бедн: бедным, бедных
без: без
бесплатн: бесплатно, бесплатное, бесплатный
бесплатну: бесплатную
бесприютны: бесприютные
благотворительн: благотворительной, благотворительных
благотворительност: благотворительности, благотворительность
благотворительны: благотворительные
богадельн: богадельни
больн: больным, больных
больниц: больницы
больны: больные
больш: большая
бур: бурного
бурятия: бурятия
был: был, была, было
быстре: быстрее
важ: важного
вв: вв
ведомств: ведомства, ведомство, ведомству
век: века
величеств: величеств, величества
вероисповедания: вероисповедания
верхнеудинск: верхнеудинск, верхнеудинска
вещ: вещами
взаимопомощ: взаимопомощи
включавш: включавшая
включал: включало
внутренн: внутренних
возникновения: возникновения
войн: войн
воспитани: воспитании
времен: времени
временн: временной
время: время
все: все, всей
всем: всем
всеподданнейши: всеподданнейший
выдав: выдавая
выдавал: выдавало
выделял: выделяло
высочайш: высочайшему
высочайше: высочайшее
где: где
гимнази: гимназии
главн: главная, главное
год: год, года, году
годах: годах
горобец: горобец
город: города, городе, городских
государственн: государственный
грамот: грамоте
два: два
девочек: девочек
девочк: девочки
дек: дек
дел: дел, делам
демаков: демакова
денежну: денежную
денежны: денежные
деньг: деньгами
деревен: деревень
дет: дет, детей, дети, детский
детск: детского
детски: детские
детям: детям
деятельност: деятельность
дмитриевич: дмитриевич
до: до
документах: документах
долидович: долидович
дом: дом, дома, доме
домашн: домашнему
доставк: доставкой
доставляя: доставляя
други: другие
духовн: духовном
его: его
един: единой
единовременну: единовременную
единовременны: единовременные
ещё: ещё
женск: женской
женщин: женщин, женщинам
жизн: жизни
жит: жить
жител: жителей
жителям: жителям
забайкаль: забайкальская
забайкальск: забайкальского, забайкальской
заведени: заведение
заведения: заведения
заведениях: заведениях
задач: задача
заключённ: заключённых
замедлял: замедляло
занималос: занималось
заработк: заработке
зат: затем
затронул: затронули
затруднял: затрудняло
землетрясени: землетрясений
значительн: значительно, значительное
из: из
известн: известно
изд: изд
изменения: изменения
им: им
имп: имп
императорск: императорского, императорской
императриц: императрицы
импери: империи
иным: иными
истори: историю
историографически: историографические
историче: исторический
их: их
как: как
калек: калек
канцеляр: канцелярией
канцеляри: канцелярии
катцин: катцина
ключевы: ключевые
количеств: количество
комитет: комитет
конц: конце
которы: которые
крас: красного
красноярск: красноярске
кратки: краткий
края: края
крест: креста
кром: кроме
кружок: кружок
кто: кто
курировавше: курировавшее
курировал: курировало
кяхт: кяхта, кяхты
кяхтин: кяхтинское
лекарств: лекарства
лет: лет
лети: летие
лечебниц: лечебницу
лечени: лечение
литератур: литературы
любител: любителей
люд: людей
малолетн: малолетних
мальчик: мальчики, мальчиков
мари: марии
мария: мария
материал: материалами, материалы
материалах: материалах
медикамент: медикаменты
медицинску: медицинскую
мест: местного
местн: местное, местным
месяц: месяц
милосердия: милосердия
министерств: министерства, министерству
михаил: михаил
младенц: младенцев
мног: многом
мог: мог
могл: могли
мож: можем
мужск: мужской
музык: музыки
мы: мы
наводнени: наводнений
наиболе: наиболее
наибольше: наибольшее
народ: народного
наук: наука
наукм: наукм
начал: начала, начале, начало, началу
начальн: начальном
независим: независимо
неимущим: неимущим
необходим: необходимо, необходимыми
необходимост: необходимости
непосредств: непосредств
нерченск: нерченске
нерчинск: нерчинск
несомненн: несомненно
нестор: нестор
нет: нет
неурож: неурожая
николаев: николаевское
николаевск: николаевского
них: них
ночлег: ночлег
ночлежн: ночлежный
нравственн: нравственном
нужд: нужды
нуждалис: нуждались
нуждающиеся: нуждающиеся
нуждающимся: нуждающимся
обеспечени: обеспечении
обеспечивал: обеспечивало
обзор: обзор
обл: обл
област: области, область
областн: областной
образ: образом
образовани: образовании
образования: образования
обув: обуви, обувь
обучалис: обучались
обучени: обучение
обществ: обществ, общества, общество
общественн: общественное
общин: община
одежд: одеждой, одежду, одежды
одн: одной
одноклассн: одноклассных
оказывал: оказывали, оказывало
окрестн: окрестных
они: они
оно: оно
оплачивал: оплачивало
организац: организацией
организаци: организаций
основ: основе
основан: основано
особенн: особенно
осталис: остались
от: от
отв: отв
отделени: отделение, отделении
отделения: отделения
открыл: открыло
открыт: открыт, открыта, открыто, открытое, открытой, открытом, открытый
открытия: открытия
отметит: отметить
отмечен: отмечено
отопления: отопления
отчет: отчет
очерк: очерк
пагинаци: пагинации
пасх: пасхи
перв: первой
перед: перед
передач: передачей
период: периодом
петербург: петербург
петербургск: петербургского
питания: питания
пищ: пищи
плат: плату
повелени: повелению
под: под
поддержк: поддержку
пожар: пожаров
пожертвования: пожертвования
позволил: позволило
позволит: позволить
пок: покой
покровительств: покровительством
покупк: покупку
пол: пола
положени: положение
положения: положения
получал: получали
получит: получить
помещени: помещением
помогал: помогали, помогало
помощ: помощи, помощь
попечени: попечение
попечения: попечения
попечител: попечителей
попечительств: попечительства, попечительство
портняжн: портняжному
порядк: порядке
порядок: порядок
послужил: послужили
пособи: пособие, пособий
пособия: пособия
постоянн: постоянной
пострадал: пострадал
пошел: пошел
прав: прав
правления: правления
праздник: праздниками
предлагается: предлагается
предмет: предметы
предоставлял: предоставляло
предоставлялас: предоставлялась
предоставлялос: предоставлялось
предоставляя: предоставляя
престарел: престарелым, престарелых
при: при
приемн: приемный
призрени: призрение
призрения: призрения
приказчик: приказчиков
прил: прил
принимал: принимали
принятия: принятия
припас: припасы
присмотр: присмотра
приход: прихода, приходских
приходск: приходской
приходящ: приходящих
приходящи: приходящие
причин: причиной
приют: приют, приюта, приюте, приюты
приютах: приютах
проблем: проблемы
просвещения: просвещения
процесс: процесс
пятидесятилети: пятидесятилетию
работ: работа, работу
развития: развития
ранен: раненым
располагавшееся: располагавшееся
рассматривается: рассматривается
рассмотр: рассмотрев
ргс: ргсу
ред: ред
редк: редких
ремесл: ремеслу
ремесленны: ремесленные
ремёсл: ремёслам
республик: республики
рождеств: рождества
рокк: рокк
росси: россии
российск: российского, российской
рубл: рублей
рукодели: рукоделию
рф: рф
сам: самым
санкт: санкт
сапожн: сапожному
сборник: сборник
себ: себе
себя: себя
седельник: седельников
селезн: селезнев
семьям: семьям
семьях: семьях
середин: середина, середине
сестер: сестер
сиб: сиб
сибир: сибири
сирот: сирот, сиротам
систем: системы
следующ: следующей
слобод: слобод
слов: слова
случаях: случаях
снабжал: снабжало
со: со
собиралис: собирались
собор: собора
собственн: собственной
современны: современные
содержал: содержало
содержалос: содержалось
содержани: содержание
создан: создана, создано
создания: создания
соизволени: соизволение
сокол: соколов
солдат: солдатам
сословия: сословия
сост: сост
составлен: составлено
состоящ: состоящих
социальн: социальное
спб: спб
специализированн: специализированное
список: список
средств: средств, средства
сретен: сретенский
сретенск: сретенск
ссуд: ссуды
ссыльнокаторжн: ссыльнокаторжных
стар: старым
стат: статей
стать: статье, статьи
столярн: столярному
существовал: существовало
так: такого
таким: таким
текст: текст
тем: тем
территори: территории
тех: тех
тип: тип
типография: типография
тог: того
токарн: токарному
том: том
торгов: торгового
троицкосавск: троицкосавска, троицкосавске
трудолюбия: трудолюбия
тюрьмах: тюрьмах
узл: узла
улучшени: улучшение, улучшением
университет: университет
уп: уп
управлени: управление
упрощени: упрощение
ускорит: ускорить
услови: условий
уст: усть
устав: устава
ухудшилос: ухудшилось
учащимся: учащимся
учеб: учеб
учебн: учебными, учебных
учебник: учебниками
учебны: учебные
ученик: ученикам, ученики, учеников
учил: учили
училис: учились
училищ: училищ, училище
училищах: училищах
учреждени: учреждение, учреждений
учреждения: учреждения
учреждениям: учреждениям
федер: федер
федоровн: федоровна
филиал: филиал
флинт: флинта
хозяйств: хозяйства, хозяйству
христов: христова
хроник: хроника
хронология: хронология
хх: хх
церковн: церковно
част: часть
частн: частное, частной
человек: человек
числ: число
чит: чита, чите
читинск: читинского, читинской
член: членам, члены
что: что
школ: школе
шумигор: шумигорский
эти: эти
это: это
этог: этого
этом: этом
являлас: являлась
