авиаотряд: авиаотрядом
авиационный: авиационных
авиация: авиации
автор: автор, авторов
активно: активно
актуальность: актуальность
актуальный: актуален, актуальным
анализ: анализ
анна: анна
апрель: апреля
аптыевич: аптыевна
аргумент: аргументы
армия: армии
артиллерия: артиллерии
аспект: аспект
аспирант: аспирант
батайский: батайскую
батальон: батальона
берлин: берлина
бершанский: бершанская, бершанской, бершанскую
беседа: беседе
беспримерный: беспримерный
бессмертный: бессмертный
библиотека: библиотека
боевой: боевые, боевых
боец: бойцов
бой: боя, боях
более: более
больница: больнице, больницы
бомбардировочный: бомбардировочный
борьба: борьбе, борьбы
братство: братства
брать: брали
бронзовый: бронзовый
будущее: будущем
будущий: будущая, будущих
быть: был, была, были, было, быть
бюст: бюст
важно: важно
важность: важности
важный: важный
варшава: варшавы
василиевич: васильевна
вдохновение: вдохновением
ведьма: ведьм, ведьмами, ведьмы
великий: великая, великой
вернуться: вернулась
весь: всей
взятие: взятие
вклад: вклад
владимирович: владимировна
влияние: влияние
внести: внесла
вов: вов
водрузить: водрузившая
воениздат: воениздате
военный: военного, военный, военных
возраст: возраста
война: война, войне, войну, войны
войско: войск
волков: волкова
вопрос: вопрос, вопроса
восприятие: восприятии
вписать: вписаны
впоследствии: впоследствии
вражеский: вражеской
время: времени, время
встреча: встречи
выдающийся: выдающиеся
выйти: вышедшая
вылет: вылетов
вынести: вынесла
выполнять: выполняли, выполнять, выполняя
высокий: высшей
высоко: высоко
вычислительный: вычислительной
вышина: вышине
газета: газета, газеты
гвардейский: гвардейской
где: где
героизм: героизм
герой: героев, героя
гетманов: гетманова
го: го
год: гг, год, года, году, годы
госпиталь: госпиталя
гражданский: гражданской
гугов: гугова
гуманизм: гуманизма
давыдович: давыдовна, давыдовны
даже: даже
дарья: дарья
дата: дата
дать: данной
два: два
действие: действия
декабрь: декабря
делать: делать
дело: дело
день: день
деятельность: деятельности
дивизия: дивизии
динамика: динамики
дискриминация: дискриминацией
дискуссия: дискуссиях
диссертационный: диссертационной
диссертация: диссертации
днепр: днепр
до: до
добровольный: добровольное
др: др
дунькин: дунькиным
евдокия: евдокии, евдокию, евдокия
единственный: единственная
единство: единства
ермолов: ермолова
женский: женских, женского
женщина: женщин, женщина, женщинам, женщины
живой: живой
жизнь: жизни, жизнь
жить: жила
забываться: забываются
заветный: заветной
задача: задачи
заключаться: заключается
захватчик: захватчики
звезда: звезды
звено: звена
звук: звуку
здание: здании, здания
знамя: знамени, знамя
значимость: значимости
значительный: значительное, значительной
идентичность: идентичности
из: из
известный: известная
изменение: изменений
именно: именно
имя: имена
инклюзивный: инклюзивного
использовать: использован
испытание: испытаний
исследование: исследование, исследования, исследованиях
историография: историография
исторический: исторических, исторического, историческом, историческую
история: истории, историю
источник: источником
июнь: июня
кавалер: кавалер, кавалера
кавказ: кавказа
кавказский: кавказский, кавказского
как: как
кандидатский: кандидатской
книга: книги
когда: когда
количество: количество
колледж: колледж
колоссальный: колоссальный
командир: командир, командиров, командиром
командование: командованием
командовать: командовала
комитет: комитетом
компания: компаниях
кондаков: кондакова
конкретный: конкретные
контекст: контексте
корреспондент: корреспондентом
который: которая, котором, которые, который
кошмар: кошмаре
краевой: краевой
край: края
краснодарский: краснодарского
красный: красного, красной
крест: креста
кто: кто
культурный: культурной, культурном
курс: курса
лететь: летящего
лидер: лидером
литература: литературе, литературы
любовь: любви
лётчица: летчиц, летчица, летчицам, лётчиц
май: мая
майор: майора
мария: мария
матрёна: матрена, матрене
медаль: медалей, медалью
медицина: медицине
медицинский: медицинского
медсестра: медсестры
между: между
международный: международным
мера: мере
миллион: миллионы
мир: мира
многий: многих
многогранный: многогранный
можно: можно
монография: монографий
москва: москве
мочь: могут, может
муж: мужа
мужество: мужества, мужество
мужчина: мужчинами, мужчины
мурманцев: мурманцева
мы: мы, нам, нас
навздречева: навздречева
награда: наград, награды
наградить: награждена
над: над
наздрачёв: наздрачевой
назначить: назначили
называть: называть
найтингейл: найтингейл
нальчиков: нальчикова
наравне: наравне
народ: народами, народу
наследие: наследие
настоящий: настоящем
научный: научная, научный
начать: начали
наш: наша, нашего
невероятный: невероятное
невздречева: невздречева
невздречевой: невздречевой
независимо: независимо
независимость: независимость
немецкий: немецкой
немецко: немецко
немного: немного
неотъемлемый: неотъемлемой
неуютный: неуютно
никулин: никулина
ноздрачёв: ноздрачева
ночное: ночными
ночной: ночной, ночные, ночных
ночь: ночи
о: об
оборона: оборону
образ: образом
обращение: обращения
обстрел: обстрел
обширный: обширна
общественный: общественной, общественном, общественных
общество: общества, обществе
обязать: обязаны
одержать: одержать
один: один, одна, одним
окончить: окончила
олицетворять: олицетворяющий
он: он
она: ее, она
они: им, их, они
опасный: опасных
опиева: опиева
определить: определить
определённый: определенный
опыт: опыт
орден: ордена, орденов
орденосец: орденосца
осведомлённость: осведомленности
освобождение: освобождение
основный: основным
оставаться: оставались, оставаться
оставить: оставила, оставили
от: от
отважность: отважности
ответственность: ответственность
отдать: отдал
отечественный: отечественная, отечественной
открыть: открыли, открыт
отметить: отметить
отмечаться: отмечается
относиться: относились
отправной: отправной
официальный: официальный
оценить: оценены
памятник: памятник
память: памяти, память
парад: параде
параллель: параллель
патриотизм: патриотизма
педагогический: педагогический
первый: первую, первых
передать: передать
переехать: переехала
период: период, периода, периодов
периодический: периодическая
печать: печать
пилот: пилотов, пилоты
писать: пишет
пламя: пламя
план: плане
площадь: площади
победа: победу, победы
повседневный: повседневная, повседневной
повышение: повышения
под: под
подвиг: подвигах, подвиги
подготовка: подготовке
поддержка: поддержке
подчинённый: подчиненных
показать: показала, показать
показывать: показывать
поколение: поколений, поколению
пол: пола
поле: поля
поликлиника: поликлиники
полк: полк
полка: полка
полный: полного
полок: полков, полком
получить: получив, получила
польский: польская
помнить: помнить, помнят
помогать: помогает
помочь: помогли
поначалу: поначалу
понимание: понимания
понять: понять
попасть: попала
порой: порой
посвятить: посвященных
после: после
послевоенный: послевоенные
поствоенный: поствоенное
поступать: поступает
потенциал: потенциала
потомок: потомков
появиться: появилась
появляться: появлялся
правда: правда
праздник: праздник
преобразить: преобразил
прийти: пришел
пример: пример, примером
принять: приняли
присуждаться: присуждается
притупиться: притупилось
проводить: проводит
продолжать: продолжает
прозвать: прозвать
профессиональный: профессиональной
прошедшее: прошедших
прошлое: прошлое
проявление: проявление
прямой: прямой
пушкин: пушкина
работа: работе
работать: работала, работая
равенство: равенстве
равноправный: равноправного
раз: раз
разный: разных
ранить: раненная, раненных
располагаться: располагался
рассказать: рассказать
рассказывать: рассказывает, рассказывала
регион: регионов
региональный: региональный
результат: результаты
рейхсканцелярия: рейхсканцелярией
ресурс: ресурс
решимость: решимость
решительность: решительности
решить: решили
родина: родине, родину
родиться: родилась
роль: роли
россия: россии
руководитель: руководитель
рф: рф
сайт: сайт
самоотверженность: самоотверженность
санинструктор: санинструктором
сбежать: сбежала
свобода: свободу
свой: свое, своей, своих, свой, свою
священный: священный
себя: себя
северо: северо
семья: семьи, семья
семёнович: семеновна, семеновне
сердце: сердцах
сила: силы
символ: символ, символом
скептически: скептически
слава: славы
след: след
следом: следом
следующий: следующему
слово: слово
сложный: сложных
служить: служили
смелость: смелости
снайпер: снайперов
снаряд: снаряда
событие: событий
совершить: совершили
советский: советский, советского, советском, советскому
современность: современности
современный: современных
создание: созданию
создать: создан
сознание: сознании
солидарность: солидарности
сохранить: сохранить
сохраниться: сохранились
социальный: социальной
союз: союза, союзе
список: список
способствовать: способствует
справедливый: справедливого
сражаться: сражаясь
ставрополец: ставропольцы
ставрополь: ставрополе, ставрополь, ставрополя
ставрополье: ставрополья
ставропольский: ставропольская, ставропольский, ставропольского, ставропольское
ставропольчанка: ставропольчанок
стать: стал, стала, стали, стало
степень: степени
стоить: стоить
стойкость: стойкость
стоматологический: стоматологической
страна: страна, страны
страх: страха
стрелковый: стрелкового
стремиться: стремясь
студент: студент
такой: такие, таким
там: там
танкист: танкистов
текуева: текуева
тема: теме, темы
тень: тени
территория: территории
техника: техники
техникум: техникум
только: только
тот: тех, того, том
точка: точкой
традиционный: традиционные
три: трех, трёх
тыл: тылу
тыловой: тыловых
тыс: тыс
тяжело: тяжело
тяжёлый: тяжелейших
увековечить: увековечены
уверенность: уверенность
удаться: удалось
удостоить: удостоенных, удостоены
универсальный: универсальная
университет: университет, университета
уничтожить: уничтожив
упасть: упадет
урок: уроки
условие: условиях
установить: установили
утро: утро
участвовать: участвовавшей, участвовала, участвовать
участие: участие, участии, участия
учить: учат
учиться: училась
факт: факты
фашистский: фашистские
федеральный: федерального, федеральный
фильм: фильмах
флоренса: флоренс
формирование: формирования
фронт: фронт, фронте
функция: функции
хава: хава
характеристика: характеристикой
хозяйство: хозяйства
хороший: лучше
хотеться: хотелось
хотя: хотя
храниться: хранится
хрупкий: хрупких
целое: целом
ценить: ценить
часть: часть, частью, частях
чей: чьи
человек: людей
через: через
четыре: четырех
чиверить: чиверь
число: числе
что: что
чувство: чувство
чувствовать: чувствовали
школа: школу, школы
электроника: электроники
электронный: электронный
это: это, этого, этом
этот: этой, этот
являться: является
яркий: ярким
