авдеев: авдеева
автодорога: автодороги
адрес: адрес
азбука: азбука
акт: акты
активно: активно
активный: активное, активную, активными
актуальность: актуальность
акцентировать: акцентирует
александрович: александровичем, александровна
алибегашвили: алибегашвили
аналог: аналог
анатолий: анатолием
андрей: андрея
аннотация: аннотация
аномалия: аномалии
архангел: архангела
архитектор: архитекторов
архитектура: архитектуре, архитектуры
архитектурный: архитектурного, архитектурное, архитектурной, архитектурные, архитектурный, архитектурным, архитектурных
аспект: аспекте, аспекты
аутентичность: аутентичности
аутентичный: аутентичное
афонский: афонского
бабровый: бабровы
база: базе
безопасный: безопасной
белгород: белгород
белгородский: белгородская, белгородский, белгородским
бережный: бережное
биография: биографии
благодаря: благодаря
близкий: близка
близость: близость
бобров: бобровых
богатство: богатстве
божий: божией
более: более
больший: большая
бороться: боролся
будущее: будущем, будущим
будущий: будущих
быть: будет, был, были, было, быть
бюст: бюст, бюста
важно: важно
важность: важности, важность
важный: важной, важную, важные, важными
вдова: вдове
вдохновлять: вдохновляет, вдохновляют, вдохновляя
ведущий: ведущей
ведь: ведь
век: веков
великий: великой
версия: версия
верующий: верующих
вести: вести
весь: всех
ветеран: ветеранов
вечный: вечной
взаимодействие: взаимодействие, взаимодействию
визуальный: визуальные
вклад: вклад, вкладе, вкладу
включать: включает
власть: власти
влияние: влияние, влияния
влиять: влияет
внести: внесли
внимание: внимание
военный: военных
возвести: возведенный
воздействие: воздействие
воздействовать: воздействуют
возможность: возможность
возникнуть: возникла
возраст: возрастов
война: войны
вопрос: вопросов
воспитание: воспитании
воспитательный: воспитательного
воспитывать: воспитывать
воспринять: восприняло
восстановление: восстановлению
вписываться: вписывающийся
время: времени, время, времён
всеобъемлющий: всеобъемлющие
встреча: встречи
всё: все
выдающийся: выдающихся
выделяться: выделяется
выживание: выживание
вызов: вызовами, вызовы
выйти: вышли
выполнить: выполнено
выполнять: выполняла
выражение: выражение
выразительность: выразительностью
выразительный: выразительным
выразить: выразить
выступать: выступает
выступить: выступила
выступление: выступлениями
выходить: выходит
гармоничный: гармоничный
где: где
геологический: геологические, геологическую
геология: геологии
глава: главу
главный: главной, главных
глобализация: глобализации
глубокий: глубже, глубоком
год: годов, году, годы, лет
горный: горных
город: город, города
городской: городской
горожанин: горожан
государственный: государственный
градостроительство: градостроительстве
гражданин: граждан
гражданский: гражданское
губкин: губкин, губкина, губкине, губкину
губкинский: губкинская, губкинский, губкинского
даже: даже
дальнейший: дальнейшему
данный: данное
дань: данью
дать: данной
два: два, двух
двое: двоих
двор: дворах
действительность: действительность
декор: декором
делать: делает
дело: делу
демонстрировать: демонстрируют
день: день, дни
дзен: дзен
диана: диана
до: до
должность: должности
должный: должна
дополнительный: дополнительные
дореволюционный: дореволюционный
достижение: достижений, достижения, достижениям
достопримечательность: достопримечательностей
доступ: доступа
доход: доходов
дух: дух, духа
духовный: духовной, духовные, духовным, духовных
единственный: единственным
елена: елена
емельянов: емельянов
епархия: епархия
ефим: ефимом
желать: желающих
женский: женских, женского
женщина: женщин, женщины
жертва: жертв, жертвы
живой: живым
жизненный: жизненную
жизнь: жизни, жизнь
житель: жителей, жители, жителям, жителями
жительница: жительница
забота: заботе
забывать: забывают
заглый: загл
задача: задачами
задуматься: задуматься
закрываться: закрывался
заметный: заметный
записной: записной
заслуживать: заслуживает
здание: здание
значение: значение, значения
значимость: значимости, значимость
значимый: значимым, значимых
значительный: значительное
зрение: зрения
иван: ивану
иверскай: иверская
играть: играли, играют
идентичность: идентичностей, идентичности, идентичность
идея: идея
идти: идет
из: из
избежать: избежать
известный: известна, известная
изменение: изменения
изначально: изначально
изображать: изображающего
изучение: изучение, изучения
икона: икона
именно: именно
имя: именем, имя
индустриальный: индустриальный
индустрия: индустрии
инициатива: инициатив
интерес: интерес, интереса
интересный: интересен
исключение: исключением
использование: использование
использовать: использовать
использоваться: используется
испытание: испытания
исследователь: исследователей
исследовательский: исследовательский
историко: историко
исторически: исторически
исторический: историческая, исторические, исторических, исторического, историческое, исторической, историческому
история: истории, историю, история
источник: источники
исход: исходов
каждый: каждому
как: как
какой: какой
карандаш: карандашом
катализатор: катализатором
кирпичный: кирпичная
классический: классическом
ключевой: ключевые
книжка: книжкой
когда: когда
композиция: композиция
компонент: компоненты
конец: конца, конце
контекст: контекст, контексте
контур: контур
конфликт: конфликтов
короткий: короткой
который: которая, которое, которую, которые, который, которым, которых
крестьянский: крестьянскую
кто: кто
культура: культуру, культуры
культурный: культурного, культурное, культурной, культурном, культурные, культурный, культурных
курс: курса
курский: курской
ландшафт: ландшафт, ландшафта
ленин: ленина
ленинский: ленинском
литература: литературы
лицо: лицах
личность: личностей, личностях
личный: личное
любой: любого
магистрант: магистрант
магнитная: магнитной
мария: мария
материал: материалы
материальный: материальные
мать: матерей, матери, мать
медь: меди
между: между
мемориал: мемориал
менее: менее
мероприятие: мероприятий, мероприятия, мероприятиях
местный: местного, местное, местными, местных
место: мест, места, место, местом
металл: металле
мещанин: мещанином
мировоззрение: мировоззрение
миссия: миссию
митинг: митинги
михаил: михаила
михайловский: михайловский
многие: многие
многий: многим, многих
многогранный: многогранную
многослойный: многослойный
множество: множества, множество
можно: можно
молитва: молитвы
молодёжь: молодежи, молодежь, молодёжи
момент: момент, момента
монастырь: монастыря
монумент: монумент, монумента
москва: москве
муж: мужа
мужество: мужество
мысль: мысль
нагрузка: нагрузку
над: над
надежда: надежды
надлежащий: надлежащую
надёжный: надежной
накладывать: накладывает
наличие: наличие
напоминание: напоминание, напоминанием
направить: направленные
напрямую: напрямую
народ: народу
народный: народные
нарратив: нарративах
население: населения
населить: населенного, населённое
наследие: наследие, наследии, наследию, наследия
настоятель: настоятелем
настоящий: настоящее, настоящим
насыщенный: насыщенной
наука: науке, науки, науку
научный: научным
национальный: национальная, национальной, национальный
невидимый: невидимыми
недра: недра
немаловажный: немаловажным
необходимо: необходимо
неотъемлемый: неотъемлемой
непосредственный: непосредственном
несломленный: несломленно
несмотря: несмотря
нефтегазовый: нефтегазовой
нефтяной: нефтяной, нефтяную
никандр: никандр
николаевич: николаевна
новый: нового, новые, новых
норма: норм
носить: носит
нравственный: нравственных
нужда: нужд
о: об
обеспечить: обеспечить
область: области
облик: облик
образ: образа, образом
образец: образцом
образование: образовании, образования
образовательный: образовательная, образовательном, образовательные
обсуждение: обсуждения
обусловить: обусловлена
общественный: общественные, общественных
общество: общества, обществу
община: общиной, общины
объединять: объединяя
объект: объект, объекта, объектами, объектов, объектом, объекты
обыденный: обыденную
один: одна
одновременно: одновременно
одноимённый: одноимённым
оказать: оказавшие, оказал
околица: околицей
около: около
окружающий: окружающий
окружение: окружении
олицетворение: олицетворение
олицетворять: олицетворяет, олицетворяют
он: его, он
она: ее, она
они: их, ними, они
онф: онф
описываться: описывается
определять: определяя
оскольцо: осколец
основа: основой
основание: основании, основания
основать: основанный
основный: основное
основываться: основываясь
особенность: особенности
особый: особое
осознать: осознать
оставаться: оставался, остаются
отвечать: отвечая
отдельный: отдельных
отечественный: отечественной
открытие: открытие, открытия
открытый: открытая, открытый
открыть: открыт
отметить: отметить
отмечать: отмечающий
отношение: отношение
отражать: отражает, отражают, отражающими
отражаться: отражается
официальный: официальный
оформление: оформление
очередь: очередь
паломничество: паломничество
памятник: памятник, памятника, памятниками, памятники, памятников, памятником, памятнику
памятный: памятных
память: памяти, память
патриотический: патриотические
первый: первый, первым
передавать: передавать, передает
передаваться: передается, передаются
перенести: перенесен
пересекаться: пересекаются
период: период
персонификация: персонификации
пласт: пласт
площадка: площадками
площадь: площади
победа: победу, победы
повседневный: повседневной
повторение: повторения
погибнуть: погибших
под: под
подвергаться: подвергаются
подвести: подведут
подвиг: подвигов
поддержание: поддержании, поддержанию
подлинный: подлинной
подобный: подобных
подросток: подростков
подчёркивать: подчеркивает, подчеркивало, подчеркивая
позволять: позволяет
поздний: позже
позиция: позицию
поколение: поколение, поколений, поколения, поколениям, поколениями
получать: получает, получают
поминальный: поминальные
понимание: понимание, понимания
понятный: понятна
посвятить: посвященным
посещать: посещает
посещаться: посещается
посещение: посещение
последний: последних
последствие: последствиями
постоянный: постоянного, постоянной, постоянным
пострадать: пострадал
построить: построен
потерять: потерявших, потерявшую, потеряла
потребность: потребностью
похоронный: похоронен
почти: почти
почтить: почтить
появиться: появилась
праздник: праздники, праздников
практический: практическое
преданность: преданности, преданность
предел: пределы
предок: предков
представитель: представителей
представлять: представляет, представляют
преумножить: преумножить
при: при
привезти: привезенная
привлекательность: привлекательность
привлекать: привлекает, привлекал, привлекают
привязанность: привязанности
прийтись: пришлось
принести: принёс
природный: природного
приходить: приходит
приходский: приходская, приходской
прихожанин: прихожан
проведение: проведения
проводить: проводимые
программа: программы
продолжать: продолжает
проект: проектов, проекты
пройти: пройденного
промышленность: промышленность
просто: просто
простой: простого
простота: простотой
протоиерей: протоиерея
прототип: прототипом
протяжение: протяжении
проходить: проходят
процветать: процветающего
процесс: процесса, процессов, процессы
прошлое: прошлое
прошлый: прошлом
проявляться: проявлялась
пункт: пункта
путь: пути
работа: работе, работы
работать: работала
рабочий: рабочие
ради: ради
развиваться: развивался
развивающийся: развивающееся
развитие: развитие, развитии, развитию, развития
различный: различных
размышление: размышления
разнообразный: разнообразное
разный: разные, разных
разрушение: разрушения
район: район, района, районом
рамка: рамках, рамки
ранение: ранениями
расположить: расположенный
рассматриваться: рассматриваются
рассмотреть: рассмотрен
реальный: реальную
ребёнок: детей
регион: региона, регионе
регулярный: регулярные
режим: режим
религиозный: религиозного, религиозные, религиозных
реставрация: реставрации, реставрация
ресурс: ресурс, ресурсов
речь: речь
риск: риску
родный: родного
роль: роли, роль
российский: российская, российских
россия: россии
рука: руках, руки
руководство: руководством
русский: русский, русскую
рф: рф
сайт: сайт
сам: самого
сведение: сведения
свидетель: свидетелями
свидетельство: свидетельства, свидетельство, свидетельством
свидетельствовать: свидетельствует
свободный: свободный
свой: свое, своего, своей, своему, своим, своих, свою
связанный: связанными
связать: связано
связь: связи
святой: свято
святыня: святыней
священник: священник
сделать: сделана
себя: себе, себя, собой
сей: сей
село: села, селе
семейство: семейства
семендяев: семендяевым
семья: семей, семью
сила: силу, силы
сильный: сильное, сильных
символ: символ, символами, символом, символы
символизировать: символизировал, символизирует, символизирующих
скромный: скромным
скульптор: скульптором
скульптура: скульптура, скульптуру
скульптурный: скульптурная
следующий: следующим
слово: слова
слой: слоев
служба: службы
служение: служение
служить: служат, служил, служит, служить
смочь: смог
собрание: собраний, собрания
собрать: собраны
событие: событий, событиях
совет: совета
советский: советские, советской
современный: современного, современному, современные, современными
содержать: содержат
соединяться: соединяется
создавать: создает
создаваться: создаются
создание: созданию, создания
создать: создать
созерцание: созерцания
созидание: созидания
солдат: солдата
сообщество: сообщества, сообщество, сообществу
сооружение: сооружений
соприкасаться: соприкасаясь
сопровождаться: сопровождалось
составлять: составляющей
состояние: состояния
сохранение: сохранение, сохранении, сохранению, сохранения
сохранять: сохраняет, сохранять
сохраняться: сохранялось
социально: социально
социальный: социальная, социальной, социальную, социальных
список: список
сплочение: сплочению
сплочённость: сплоченности
способствовать: способствовало, способствует, способствуют, способствующих
среди: среди
средство: средство
сталкиваться: сталкивается
становиться: становится, становятся
становление: становлении
стать: стал, стали, стало
статья: статье
стиль: стиле
стойкость: стойкость
столетие: столетий
стоящий: стоящая
страна: страны
стратегия: стратегий
страх: страха
стремительный: стремительного
стремиться: стремящихся
строительство: строительства
структура: структуре
судьба: судьбу
сфера: сферы
счёт: счет
сын: сыновей
такой: такие, таким, такими, таких, такое
тарапанов: тарапанова
тем: тем
тема: теме, темы
территориальный: территориальный
территория: территории
технология: технологии, технологий
типичный: типичную
только: только
тоска: тоски
тот: теми, тех, том, тот
точка: точки
трагедия: трагедии
традиционно: традиционно
традиция: традиции, традиций
требовать: требуют
тревога: тревоги
три: три
трудный: трудные
туризм: туризм
турист: туристов
туристический: туристическую
тяжёлый: тяжёлые
уважать: уважать
уважение: уважение, уважении, уважения
увековечивание: увековечиванию, увековечивания
увеличение: увеличению
удачно: удачно
уделяться: уделяется
узнать: узнать
уйти: ушедших
укрепление: укреплению
укреплять: укрепляют, укрепляющих
улица: улицу
университет: университет
уникальный: уникальный
условие: условия, условиях
услуга: услуг
установить: установлен
установленный: установленных
устраиваться: устраиваются
утрата: утрату, утраты
участие: участие, участии
участник: участниками
учитывать: учитывая
учиться: учится
учёный: ученого, ученому, ученых
факт: факт
фигура: фигура, фигуры
формирование: формировании
формировать: формировавших, формирует, формируют, формирующих, формируя
фронт: фронте
функционировать: функционировать
функция: функции
фёдорович: федоровна
характер: характер
хозяйство: хозяйство
хороший: лучше
хорхордин: хорхордина
храм: храм, храма, храме
хрупкость: хрупкость
целый: целые
ценить: ценить
ценность: ценностей, ценности
центр: центр, центром
централный: централного
центральный: центральная
церковный: церковно
церковь: церковь
часто: часто
часть: частью
человек: людей
чем: чем
через: через
что: чего, чему, что
широкий: широкие
шишков: шишковым
школа: школа
школьный: школьного
шорстовый: шорстово
экономика: экономику
экономический: экономическом
экран: экрана
электронный: электронная, электронный
элемент: элемента
эмоциональный: эмоциональную
энциклопедия: энциклопедия
эпоха: эпохах
этический: этических
это: это, этом
этот: эта, эти, этой, этот
эффективный: эффективной, эффективных
являться: является, являются
