активн: активно, активной
активны: активные
акцент: акцента
александр: александра
американск: американской
анализируется: анализируется
анархист: анархисты
андреевн: андреевна
аннотация: аннотация
бедстви: бедствий
бездн: бездну
беспощадн: беспощадное
библиотек: библиотеки
биографи: биографии
ближн: ближнего
блум: блум
бо: бо
боев: боевых
больш: больше
боролас: боролась
боролис: боролись
боролся: боролся
борц: борцы
борьб: борьбе, борьбой, борьбы
будницким: будницким
был: была, были, было
быт: быть
важну: важную
ввергл: ввергли
век: века, веке
вер: вера, веры
вестник: вестник
взгляд: взгляда
взойт: взойти
вид: виде
видел: видели
виделис: виделись
виселиц: виселицу
вклад: вклад
включал: включали
власт: властей, власти
внесл: внесли
внест: внести
вовлечен: вовлечены
воздействи: воздействие
войт: войти
волкенштейн: волкенштейн
волн: волны
воля: воля
восприяти: восприятии
все: всей
всег: всего
вследстви: вследствие
втор: второй
входивш: входивших
выбират: выбирать
выступивши: выступившие
выявит: выявить
героизаци: героизацию
героизировал: героизировала
героин: героинь
глаз: глазам, глазами
глубок: глубоко
год: годов
грамот: грамоте
груб: грубая, грубое
гуманност: гуманности, гуманность
дал: дало
данн: данной, данным
дат: дата
движени: движение, движении
движения: движения
двойственност: двойственность
дворянк: дворянки
действиях: действиях
действовавш: действовавших
дел: делом
делал: делали
дерзк: дерзкая
дет: детей, дети
деятельност: деятельность
деятельность: деятельностью
дик: дикое
до: до
добиться: добиться
должн: должны
дорог: дорогих
достойн: достойна
доходящи: доходящий
друг: другой
другим: другим, другими
думат: думать
душ: души
дьяволь: дьявольское
дьявольским: дьявольским
европейски: европейские
его: его
ее: ее
ей: ей
елизавет: елизавета
ему: ему
ест: есть
её: её
жалет: жалеть
жен: женская, женских, женское
женск: женской, женском
женски: женские
женщин: женщин, женщина, женщинами, женщины
женщинах: женщинах
жертв: жертву
жестокост: жестокость
жизн: жизнь
жизнен: жизненного
журналистк: журналистки
заложил: заложила
занимавш: занимавших
занималис: занимались
западн: западное
заплатил: заплатили
заражаются: заражаются
засулич: засулич
зат: зато
звер: зверская
значим: значимых
значительн: значительный
зрения: зрения
играл: играли
иде: идей
идеал: идеалам
идеализм: идеализм
из: из
известн: известных
издательств: издательство
изменени: изменений, изменению
изменит: изменить
изображающ: изображающая
изобретенн: изобретенное
иллюстрация: иллюстрация
им: им
имен: имен, имена
именн: именно
ими: ими
имя: имя
индиан: индианы
инициировал: инициировал
институт: институт
интеллигентн: интеллигентной
интеллигенци: интеллигенции
исследователь: исследовательская
исследовательниц: исследовательницы
истори: истории
историографи: историографии
историче: исторических
история: история
их: их
казан: казанский, казань
как: как, каких, какое
календар: календаре
качеств: качеств
ключев: ключевых
ключевы: ключевые
котор: которая, которое, которой
котору: которую
которы: которые
крестьян: крестьянских
крестьянк: крестьянки
крестьянств: крестьянства
кров: крови
кружк: кружков
культур: культуры
либеральн: либеральной
литератур: литературы
личност: личности
люб: любое
матер: матери
медицин: медицины
международн: международных
месть: местью
мешают: мешают
мещанк: мещанки
мир: мирного
мирн: мирным
мног: много
могут: могут
может: может
мотиваци: мотивацию
мошин: мошина
мужеств: мужества
мужчин: мужчин, мужчинами
мучениц: мученицы
мучениче: мученическая
наваждени: наваждение
над: надо
наиболе: наиболее
найт: найт
народ: народа
народн: народная
народниц: народниц, народницы
народницах: народницах
народническ: народническом
народничеств: народничества, народничестве, народничество
нас: нас
населени: населению
насили: насилие
насильственн: насильственное
начал: начала, начале, начало
начинают: начинают
невозможност: невозможность
негативны: негативные
нее: нее
нежел: нежели
нежност: нежность
немног: немногих
несмотря: несмотря
несомненн: несомненно
ни: ни
нормальн: нормальный
обагрят: обагрять
обвинял: обвиняла
образ: образ
образования: образования
образц: образцом
обращения: обращения
обучал: обучали
обществ: общество
обществен: общественного
общественн: общественное, общественных
общественност: общественности
одинаков: одинаково
одичани: одичанию
одн: одной
одним: одними
оков: оков
оксфорд: оксфордская
он: он
она: она
они: они
определит: определить
организаци: организации, организаций
освобождения: освобождения
основ: основам, основу
осознани: осознании
осуждал: осуждала, осуждали
от: от
ответ: ответом
открывал: открывали
отмеч: отмечая
отмечал: отмечали
относится: относится
отношени: отношение, отношений
отреагировал: отреагировали
отставал: отставала
оценивал: оценивали
очеред: очередь
пагубн: пагубное
парламент: парламент
перв: первой, первом
перву: первую
перевоспитания: перевоспитания
передовы: передовые
пережит: пережить
перераспределени: перераспределению
перов: перовская
перовск: перовской
петербургск: петербургского
писавш: писавшая
подвиг: подвиг
подготовк: подготовке
подпись: подписью
подсчет: подсчетам
позици: позиции
покров: покровская
покушения: покушения
политиче: политическая
политически: политические
половин: половины
помещалис: помещались
помещен: помещена
поможет: поможет
попирают: попирают
портнягин: портнягина
порядк: порядков
постоянн: постоянно
построит: построить
пот: потому
потерял: потеряли
поэт: поэтому
прав: прав, права
правд: правда
преданност: преданности
предназначения: предназначения
представител: представители
представительниц: представительницами
представлен: представлены
представляя: представляя
прежд: прежде
пресс: пресса, прессы
преступлени: преступлений
при: при
приводим: приводимых
призывал: призывала, призывали
пример: примером
принимал: принимала
приучает: приучает
причин: причины
пропаганд: пропагандой
просветительск: просветительской
противник: противником
протягивает: протягивает
процесс: процессы
психологи: психологии
публицистик: публицистике
пут: путем, путь
работ: работе
рабоч: рабочих
рабств: рабства
равноправи: равноправие, равноправию
радикализм: радикализм
радикальны: радикальные
развити: развитие
различн: различных
разн: разных
расправ: расправа
рассматривается: рассматривается
рассматривалис: рассматривались
рассматриваются: рассматриваются
революци: революцию
революцион: революционного
революционн: революционной, революционном, революционный
реформ: реформы
родин: родины
рол: роли, роль
росси: россии
российск: российской, российском
российски: российские
рук: руки
руководящи: руководящие
рус: русское
русски: русские
русску: русскую
рф: рф
ряд: ряды
сам: самих
самим: самими
самоотверженност: самоотверженности
самопожертвования: самопожертвования
санкт: санкт
свидетельствует: свидетельствует
сво: свое, своего, свои
свобод: свободу, свободы
свободн: свободное
связан: связаны
семь: семью
середин: середине
сил: сила
символ: символом
скоре: скорее
следствия: следствия
слов: слова
слоёв: слоёв
служат: служат
смерт: смерть
смогл: смогла
снабжен: снабжена
событиям: событиям
событиях: событиях
совершени: совершении
современ: современного
современн: современной, современных
содействуют: содействуют
создат: создать
сознательн: сознательной
состав: состав, составе
софья: софья
социалист: социалисты
социалистическ: социалистического
социальн: социальной, социальный, социальных
социальны: социальные
сочувствовал: сочувствовали
список: список
способ: способов
сред: среди
средств: средство
стал: стал, стали, стало
стать: статье
сторон: стороны
стр: строй
стремилис: стремились
существовал: существовало
сфер: сферы
считал: считали
та: та
так: таких
таки: такие
тел: телом
террор: террор, террора, терроре
терроризм: терроризм
террорист: террористов
террористк: террористки
террористках: террористках
террористок: террористок
теряет: теряет
тесн: тесно
тог: того
тольк: только
том: том
точк: точки
точн: точно
тудент: тудент
тьм: тьмы
угнетения: угнетения
удалос: удалось
уже: уже
умеют: умеют
университет: университет, университета
употреблялис: употреблялись
усовершенствовани: усовершенствованию
участвовал: участвовала, участвовали
участи: участие
участниц: участницей, участницы
федеральн: федеральный
феминизм: феминизм
феминистиче: феминистическое
феминистк: феминисткам, феминистки
феминисток: феминисток
феминистск: феминистского
феномен: феномен
фигнер: фигнер
фигур: фигур
формирования: формирования
фотографи: фотографии
фундаментальн: фундаментальных
хартнет: хартнет
ход: ход
хх: хх
царя: царя
целу: целую
цен: цена
част: часто
член: членов
что: что
чужд: чужды
чутки: чуткие
школ: школу, школы
эмансипаци: эмансипации
энциклопедия: энциклопедия
эсеров: эсеровских
этих: этих
это: это
этом: этом
этот: этот
эшафот: эшафот
является: является
ярки: яркие
