абстракция: абстракция
айлеей: айлееев
академия: академии, академия
активно: активно
алексеевич: алексеевич
алексеевский: алексеевская
амбулаторный: амбулаторном
анализ: анализа
анатолиевич: анатольевна
антон: антон
аптечный: аптечному
армия: армии, армия
археологический: археологическим
архипов: архипов
батый: батыя
безусловно: безусловно
белозерский: белозерский
бескрайний: бескрайним
более: более
болезнь: болезни
болеть: болели
больница: больница
больничный: больничными
больной: больными
большой: большого, большое, большом
бороться: боролась
бум: бума
быть: будет, будут, был, была, были, было, быть, суть
важный: важной, важную, важным, важных
вассал: вассалы
ведьма: ведьм
век: века, веках, веков
великий: великой
вести: вести
вестник: вестник
весь: всего, всех
вещество: веществами
взаимодействовать: взаимодействует
власть: власти, власть
влияние: влияние, влиянием
внедрить: внедрены
внимание: внимание
вода: водой
военнослужащий: военнослужащих
военный: военной
возникнуть: возникла
воинственный: воинственных
вокруг: вокруг
вопрос: вопрос, вопросам
впитывать: впитывала
вполне: вполне
врач: врачей
время: времен, времена, времени, время
всевозможный: всевозможным
всегда: всегда
всё: все
выбрать: выбранного, выбранной
вывод: вывод, выводам
выдающийся: выдающийся
выпускать: выпускающее
выход: выхода
выше: выше
гален: галена
галин: галинов
где: где
генерал: генерал
гиппократ: гиппократа
главный: главной
глаз: глазах
говорить: говорить, говоря
год: год, годам, годом, году, годы
гоняться: гонялись
госпиталь: госпитали
государство: государства, государство, государством
граничить: граничат
греческий: греческих
губернатор: губернатора
даже: даже
дань: дань
дата: дату
дать: дать
демонстрировать: демонстрирующей
дискуссия: дискуссии, дискуссиях
дисциплина: дисциплин
длительный: длительный
довольно: довольно
документ: документах, документом
долгий: долгой
должный: должен
достаточно: достаточно
доступный: доступные
древнерусский: древнерусского
древний: древних
другой: другие
духовный: духовная, духовные
елена: елена
естественно: естественно
есть: есть
животное: животного
жизнь: жизни, жизнь
заболевание: заболеваниям
заведение: заведение
зависеть: зависела
зависимость: зависимости
завоевание: завоевания
завоеватель: завоевателей
задать: задать
зародиться: зародилась
захватчик: захватчиков
захотеть: захотела
защита: защитой
земля: землей, землях
знание: знания
знать: знали
знахарь: знахари
золотой: золотой
иван: иван
иго: иго
из: из
известно: известно
известный: известное
изд: изд
измениться: изменившихся, изменилась
изменяться: изменялась
изучаться: изучается, изучаются
изучение: изучения
иметь: имеет, имела, имеют
иметься: имеющихся
империя: империи, империя
индийский: индийскими
иной: иными
интерес: интересах
интересный: интересный
искусство: искусство
использование: использования
использовать: используемые
исследование: исследований
историография: историографии
исторический: исторические, историческое, исторической, историческую
история: истории, историю, история
источник: источникам, источников
исчезнуть: исчезли
итак: итак
итог: итог
казань: казань
как: как
какой: какое, какой, каком
капище: капищ
картина: картину
картографический: картографическим
катыр: катыр
келья: кельи
киево: киево
кирилло: кирилло
китай: китая
ключевой: ключевые
княжество: княжеств, княжества
князь: князья
когда: когда
колдун: колдунов
комментарий: комментарий, комментариями
конгломерат: конгломерат
конечно: конечно
конкретный: конкретный
коренья: кореньев, коренья
который: которая, которые, который, которыми
кочевник: кочевников
краткий: краткая, краткое
кроме: кроме
крупный: крупное
кто: кем
культура: культура, культуре
культурный: культурная
лавр: лавра
лауреат: лауреат
лекарственный: лекарственными
лекарство: лекарства, лекарством
лекарь: лекари
лечение: лечение, лечении, лечения
лечить: лечить
литература: литературы
литературный: литературных
лишь: лишь
любой: любая
мазь: мазями
маленький: меньше
мамонт: мамонтом
массовый: массовые
масштаб: масштаба
масштабный: масштабным, масштабных
материал: материалов
медицина: медицина, медицины
медицинский: медицинские, медицинского, медицинское, медицинской
между: между
мера: мере
метод: методов, методы
механизм: механизм
мешать: мешали
многие: многие
многогранный: многогранна
можно: можно
момент: момент
монастырский: монастырская
монастырь: монастыре, монастырь, монастыря, монастырям
монгол: монголов, монголы
монголия: монголией
монголо: монголо
монгольский: монгольская, монгольской
москва: москвы
мочь: могла
мурад: мурад
мы: мы, нами
над: над
назвать: назвали
наиболее: наиболее
найти: найти
налёт: налета
например: например
наработка: наработки
народ: народов, народом
народность: народностей
народный: народной, народные, народных
настой: настоями
настолько: настолько
наступление: наступление
наука: наук, наука, наукой
научный: научная, научный
находиться: находилась
национальность: национальность
начало: начала
начаться: началось
наш: нашей, наши, наших
нашествие: нашествие, нашествия
небольшой: небольшой
невозможно: невозможно
независимо: независимо
некий: некая
некоторый: некоторыми, некоторых
нельзя: нельзя
немой: нем
необходимо: необходимо
необходимость: необходимость
необходимый: необходимым
непосредственно: непосредственно
непострадавший: непострадавший
несколько: несколько
никитин: никитина
нобелевский: нобелевской
новаторский: новаторские
новый: новому
нормально: нормально
нормальный: нормальный
нрав: нравы
о: об
обзор: обзор
область: области
облик: облика
образ: образ
образоваться: образовалось
обращаться: обращаясь
обслуживание: обслуживание, обслуживания
обходить: обходимых
обширный: обширные
общий: общая
объединить: объединить
объяснение: объяснения
объясняться: объясняются
обычай: обычаи
одолевать: одолевали
он: его, ему
она: ее, ней, она
они: их, ними
операция: операции
оперирование: оперирования
описание: описание
определённый: определенный
опыт: опыт
организм: организм
орда: орды
орден: ордену
орёл: орёл
основа: основой
основное: основном
основной: основные
особенность: особенности
осознать: осознать
оставаться: остается
оставить: оставило
остановиться: остановилась, остановилось
от: от
отвар: отварами
отдалить: отдаленных
отделение: отделение
открыть: открыта
отметить: отметить
относиться: относятся
отношение: отношении, отношения
отпор: отпор
отрасль: отрасль
отремонтировать: отремонтирован
отсталость: отсталости
отсутствие: отсутствие
охватывать: охватывает
охватываться: охватывается
охрана: охраны
очень: очень
павлов: павлов
палата: палатами
первый: первого, первое
перебой: перебоях
перевести: переведены
переживать: переживает
переходить: переходите
период: период, периода, периоды
петрович: петрович
печорский: печорская
планироваться: планируется
платить: платить
племя: племен
плод: плоды
плодотворный: плодотворной
поведение: поведения
повествование: повествования
повлиять: повлияет
повод: поводу
повседневный: повседневная
погром: погромов
под: под
подверженный: подвержен
подготовка: подготовке
подробный: подробная
подтверждать: подтверждающим
подтверждение: подтверждения
поединок: поединка
пожалуй: пожалуй
поле: поле
политика: политика
политический: политическим, политических, политическое, политической, политическую
полный: полного, полной
помимо: помимо
помнить: помнить
помочь: помогло
помощь: помощи
понять: понять
попадать: попадает
попасть: попала
поскольку: поскольку
после: после
последовательность: последовательность
постепенно: постепенно
потому: потому
потребность: потребности
поэтому: поэтому
правило: правил
правитель: правителями
практика: практики
практически: практически
предок: предки
предоставить: предоставить
представить: представлена
представлять: представляет, представляла
прежде: прежде
прежний: прежнему
премия: премии
при: при
привычный: привычного
применение: применения
применяться: применялось
принять: приняты
приобрести: приобрела
природа: природе
приходить: приходили
причина: причиной
приём: приемов
проведение: проведения
продолжать: продолжали
продолжаться: продолжалась
проживать: проживал
произойти: произошло
происходить: происходило, происходящая
происхождение: происхождения
просить: просили
просто: просто
простой: простой
простор: просторам
протекание: протекания
процентный: процентном
прошлое: прошлого
психиатрия: психиатрии
развиваться: развивалась
развитие: развитие, развитии, развития
раздробленность: раздробленность
различный: различные, различных
разный: разному
разобщённость: разобщенность
разрушить: разрушен
район: районах
рамка: рамках
раненый: раненых
раскрытие: раскрытия
раскрыть: раскрыть
расположить: расположенный
распространение: распространению
рассказать: рассказать
рассматривать: рассматриваемой, рассматривать
рассматриваться: рассматривается
рассмотреть: рассмотреть, рассмотрим
регион: регионах
результат: результат, результате
ресурс: ресурсы
рецессия: рецессии
ровесница: ровесница
роман: романов
российский: российский, российской
россия: россии
руководитель: руководитель
русский: русская, русские, русских, русского, русской
русь: руси, русь
рухнуть: рухнула
рф: рф
саванна: саванны
сам: самих, само, самого, самой
самый: самое
сарафан: сарафанов
светский: светские, светской
свой: своей
сделать: сделано, сделать
себя: себе, себя, собой
север: севере
северный: северных
сегодня: сегодня
сильный: сильный
симоново: симонова
сказать: сказал
след: след
следующий: следующим
слово: слова, словами
служба: службы
служить: служил
случай: случаях
слушатель: слушатель
собирать: собирая
собрать: собрать
событие: событие, событием, событий, событиям
совершенно: совершенно
содержаться: содержатся
создать: созданная, создано, создать
сознание: сознанием
сообщаться: сообщаются
соответственно: соответственно
соответствующий: соответствующих
состав: состава
состояние: состояние, состоянии, состояния
состоять: состоящая
социальный: социальную
специалист: специалистов
список: список
сплотиться: сплотиться
сплочённость: сплоченности
способствовать: способствовало
сразу: сразу
средний: средние
средство: средств
ссср: ссср
стабильный: стабилен
стагнация: стагнации
становление: становление, становления
стать: стал, стала, стало
статья: статьи
стена: стенах
стоить: стоит
столь: столь
стояние: стоянием
существовать: существовала
сфера: сферы
считать: считаем
считаться: считается
такой: такие, такое, такой
татарин: татар, татары
татарский: татарский, татарского, татарское, татарской, татарскую
татарстанский: татарстанской
тема: темы
тенденция: тенденция
теоретический: теоретических
территория: территории, территорию
тесно: тесно
тибетский: тибетской
тогда: тогда
тоже: тоже
только: только
тот: тех, того, том
трава: трав, травами
традиционно: традиционно
традиция: традиции
трансформироваться: трансформировалась
труд: трудам, трудов
тюркский: тюркского
угра: угре
уделяться: уделяется
удобный: удобного
удовлетворить: удовлетворить
уже: уже
указанный: указанный
улучшение: улучшения
умерший: умерших
умирать: умирали
упоминаться: упоминалось
уровень: уровне
усилие: усилия
установление: установлением
ухаживать: ухаживали
учебник: учебников
учебный: учебное
учреждение: учреждения
учёный: ученый
факт: факт, фактов
фармация: фармации
федеральный: федеральной
федерация: федерации
феодальный: феодальная
формироваться: формировались, формируются
хан: хана, ханам, хану
ход: ходе
хотеться: хотелось
хотя: хотя
храм: храм, храме, храмы
хроника: хрониках
хрупкий: хрупкий
целитель: целителей, целителями
целительница: целительницы
целительство: целительства, целительство
центр: центром
централизация: централизация
церковь: церквей, церковь
часть: части, частью
человек: людей, люди, человека
человеческий: человеческий, человеческого, человеческой
чем: чем
череда: череду
читатель: читателям
что: что
чудово: чудово
чёткий: четкого
широкий: широкое
широко: широко
экономика: экономике
экономический: экономическую
эпоха: эпохе, эпохи, эпоху
этап: этапе, этапы
это: это, этого, этом
этот: эта, этой, этот
юрьевский: юрьевская
явление: явление, явления
являться: является
ярлык: ярлык
