абвер: абвер, абвера
агент: агентами, агентов, агенты
агентура: агентуры
акт: актов
акцентировать: акцентировать, акцентируя
александр: александр
анализ: анализа
анализироваться: анализируются
аннотация: аннотация
арест: арест, арестом
арестовать: арестованных
армия: армии, армий
архив: архивов
архивный: архивные
бандитизм: бандитизме
батальон: батальона
беженец: беженцев
безопасность: безопасности
безошибочно: безошибочно
белозеров: белозеров
белорусский: белорусских
библейский: библейское
бланк: бланки
боевой: боевых
боеприпас: боеприпасами
боеспособность: боеспособности
более: более
больший: большее
борьба: борьбе, борьбу, борьбы
буква: букв
бывший: бывшие
былшибболет: былшибболет
быть: был, была, были, было
важный: важен, важные, важный
введение: введении
ввести: введена, ввести
вводиться: вводилась, вводились
вели: вели
великий: великой
венгрия: венгрии
вербовка: вербовку
вероятный: вероятные
веский: веских
весь: всего, всем, всех
ветеран: ветерана
вече: вече
вещь: вещи
визуальный: визуальную
включать: включающий
вкп: вкп
владелец: владельца, владельцы
власть: власти
влияние: влияние, влиянии
влксм: влксм
внедрение: внедрение, внедрения
внесудебный: внесудебного
внешне: внешне
внимание: внимание
внутренний: внутренними
военнослужащий: военнослужащими, военнослужащих
военный: военная, военное, военной, военные, военных
возвращать: возвращать
возникать: возникает
воинский: воинские, воинских
война: войне, войны
войско: войск, войска
войсковой: войсковыми
вопрос: вопрос, вопросы
вор: воров
враг: врага, врагов
вражеский: вражеских, вражеской
время: время
всегда: всегда
вскрытие: вскрытии
вступить: вступил
всё: все
вторжение: вторжения
входить: входила, входили
вывод: выводы
выглядеть: выглядели
выдавать: выдавала, выдавали, выдавало
вызов: вызовами
выпустить: выпустили
выражение: выражение
выраженный: выраженный
высокий: высокой
высылаться: высылаться
вытекать: вытекающей
вычислять: вычисляли
вышеперечисленный: вышеперечисленного
выявление: выявления
выявлять: выявляли
гарнизон: гарнизонов
генерал: генерала
гербовый: гербовых
германия: германии, германия
гко: гко
главное: главное
глобальный: глобальных
глубокий: глубже
глубоко: глубоко
глянец: глянец
говорить: говорит
год: гг, года, году, годы
городской: городского
госпиталь: госпитали
государственный: государственной
граница: границе
группа: групп, группа
даже: даже
дальнейший: дальнейших
дамаскин: дамаскин
данные: данных
дата: дата
дать: данной
два: два
дезертир: дезертир, дезертирами, дезертиров
дезинформация: дезинформации
дезорганизация: дезорганизации
действие: действие, действий, действия, действиях
действовать: действующей
делать: делали
делаться: делались
дело: дел, дела, делам, деле, дело
демонстративный: демонстративного
день: дней
дестабилизация: дестабилизации
деятельность: деятельности, деятельность
диверсант: диверсантов, диверсанты
диверсионный: диверсионных
дивизия: дивизий
директива: директивы
дислокация: дислокации
дисциплина: дисциплин
до: до
добровольно: добровольно
довольствие: довольствия
доказательство: доказательств
докладная: докладные
документ: документам, документах, документов, документу, документы
должный: должны
дом: домов
допрашивать: допрашивать
допрос: допроса
допускаться: допускался
дорога: дорог, дорога
достижение: достижения
доступ: доступа
другой: другие
дух: дух
егоров: егорова
единый: единая
есть: есть
железнодорожный: железнодорожные
железный: железных
женщина: женщин
жилой: жилых
житель: жителями
забросить: заброшенных
заброска: заброске, заброску
завладеть: завладеть
заградительный: заградительной, заградительные, заградительных
заградотряд: заградотрядах, заградотряды
задача: задачи
задержать: задержано
задерживать: задерживать
закономерно: закономерно
замаскировать: замаскированы
заниматься: занимались
запад: западе
западный: западной
записка: записки
засада: засад
заслон: заслонов, заслоны
зафронтовой: зафронтовую
зачастую: зачастую
зеленин: зеленин
знать: знали
значение: значении
значительный: значительным
зона: зонах, зоны
идентификация: идентификацию
идти: шли
из: из
известный: известных
излишний: излишне
измена: изменой, измены
изменник: изменников
иметь: имели
иной: иным
иностранный: иностранными, иностранных
институт: институт
инструкция: инструкции
информация: информации, информацию
исключение: исключения
исключительный: исключительных
использование: использование
использовать: использовали
использоваться: использовались, использовалось
исправление: исправления
исследование: исследование, исследования
истинный: истинных
истопник: истопникам
история: истории
исходный: исходным
июль: июле, июля
июнь: июне, июня
каждый: каждые
как: как
какой: какое
кандидат: кандидатов
канцелярский: канцелярским
категория: категория
кафедра: кафедра
качественный: качественный
качество: качества, качестве, качество
кимакович: кимакович
ключевой: ключевую, ключевые
книга: книга
книжка: книжки
количество: количеством
командир: командира, командиров
командировочный: командировочных
командование: командованию
коммунистический: коммунистической
комплектоваться: комплектовалась
компонент: компонент
конец: концу
контакт: контакты
контроль: контроль
контрразведка: контрразведка, контрразведки
контрразведчик: контрразведчики
контрразведывательный: контрразведывательного, контрразведывательной, контрразведывательные, контрразведывательный, контрразведывательных
конфисковать: конфискованы
конфликт: конфликта
который: которое, которые, который, которых
красноармейский: красноармейской
красный: красной
критический: критические
крупный: крупным
легенда: легенды
леонидович: леонидовна
лето: летом
линия: линию
литература: литературы
лицо: лиц, лица
личный: личного, личные
лишь: лишь
ловить: ловить
ловля: ловлей
ложь: ложь
майор: майора
маршрут: маршрутами, маршруты
массировать: массированной
масштаб: масштабах
материал: материале, материалы
махорка: махорка
медаль: медали
медсестра: медсестрами
мелкий: мелким
мемуары: мемуары
меняться: менявшийся
мера: мер
местный: местного
место: места, местах
месторасположение: месторасположении
месяц: месяц, месяцы
метод: методах, методом, методы
механизм: механизмов
мзареулов: мзареулов
минск: минске
мир: мир
мнение: мнению
мнимый: мнимых
можно: можно
момент: момент, момента, моментах, моментов
моральный: моральный
москва: москва, москвой
московский: московского
мочь: могли, могло
мощь: мощи
мы: мы
наблюдение: наблюдение, наблюдению
наведение: наведению
над: над
надзор: надзор
наземный: наземные
наличие: наличии
нападение: нападения
написание: написание
направление: направления
например: например
нарком: наркома
нарушитель: нарушителей
население: населения
населить: населенным
наследие: наследии
наука: наука
находиться: находившихся
нацистский: нацистской
начало: начала, начале
начальник: начальник, начальникам
начальный: начальном, начальный
начать: начали
невидимый: невидимый
недостаточный: недостаточное
недочёт: недочетах
неизношенный: неизношенными
некий: некого
некоторый: некоторые, некоторых
немец: немца, немцами, немцев, немцы
немецкий: немецкие, немецким, немецких, немецкого, немецкой
необходимый: необходима
неожиданный: неожиданного
непосредственно: непосредственно
нержавеющий: нержавеющие
нехватка: нехватках
нить: нить
нквд: нквд
нкгб: нкгб
нко: нко
новый: новыми
номер: номером
носить: носила
ноябрь: ноября
о: об
оба: оба
обеспечение: обеспечении
область: области
обложка: обложки
обнаружить: обнаружили
обозначать: обозначающее
оборона: оборона, обороны
оборонительный: оборонительной, оборонительный
образ: образом
обращать: обращали, обращать
обращение: обращения
обстановка: обстановки
обстоятельство: обстоятельств
обсуждаться: обсуждается
обучаться: обучалось
общественный: общественного
общество: общество
обычный: обычных
огромный: огромный
один: один
одновременный: одновременной
оказаться: оказались
оккупация: оккупации
оккупировать: оккупированной, оккупированных
около: около
октябрь: октябре, октября
он: его, него
она: ее
они: им, их, них, они
оперативно: оперативно
оперативный: оперативной, оперативную, оперативные
операция: операции, операций
опираться: опирается, опираясь
оппонент: оппоненты
определённый: определенный
опыт: опыт, опыта
орган: органами, органах, органов, органы
организация: организации, организациях
организованность: организованности
организовать: организовать
организовывать: организовывать
орден: ордена
оружие: оружием, оружия
орфографический: орфографические
освободить: освобожденных
осень: осени
осмотр: осмотре
основа: основ, основе
особенно: особенно
особенность: особенность
особист: особисты
особый: особого, особое, особом, особые, особым, особыми, особых
остаться: оставшихся
остряков: острякова
осудить: осужденных
осуществлять: осуществляли
от: от
отвлечение: отвлечению
отдел: отдела, отделам, отделами, отделе, отделов, отделы
отделение: отделение
отечественный: отечественной
отменить: отменено
отмечаться: отмечалось
отпускной: отпускных
отряд: отрядов, отряды
отстать: отставших
оттенок: оттенок
отчественный: отчественной
отчётность: отчетности
офицер: офицерам
официантка: официантками
охота: охоту
охрана: охране
очень: очень
очередь: очередь
ошибка: ошибки
паникёр: паникерами
папироса: папиросы
пара: парах
партия: партии
пассажир: пассажиров
патруль: патрули
педагогический: педагогического
первый: первая, первую, первые, первых
перевербовка: перевербовку
переводиться: переводились
перевозка: перевозок
перед: перед
передаваться: передавались
передвижение: передвижения
передовой: передовой, передовую
переименовать: переименованное
перекрёсток: перекрестках
переносный: переносном
печать: печатей, печати, печатями
план: планов
плен: плена, плену
пленный: пленных
поверхностный: поверхностный
повреждение: повреждение
повышение: повышению
под: под
подвергаться: подвергались
подготовить: подготовленного
подготовка: подготовке
подделка: подделке
подделывать: подделывали
поддельный: поддельным
поддержание: поддержания
подниматься: поднимаются
подобный: подобных
подозревать: подозреваемого, подозреваемые
подразделение: подразделению
подросток: подростков
подрывной: подрывной
подступ: подступах
подчиняться: подчинялась
поезд: поездах
позволять: позволяет, позволяющее
поздний: позже
поймать: пойманных
политический: политических
положение: положения
полок: полков
полоса: полосе
получаться: получалась
получить: полученную, получил, получили
помимо: помимо
помогать: помогали
помощь: помощь
понимание: понимания
понятно: понятно
понять: понять
попадать: попадали
поражение: поражения
поручение: поручению
порядок: порядка, порядок
после: после
пост: постов
постепенно: постепенно
постоянный: постоянными
построить: построенные
поступать: поступающей
потенциальный: потенциальными
потом: потом
потому: потому
правда: правда
правительство: правительства
право: право
практика: практика, практику
практиковать: практиковал
прачка: прачками
предатель: предателей
предоставить: предоставил
предотвращение: предотвращении
предписывать: предписывал
предприятие: предприятиях
представление: представление, представлении
представлять: представляем
преобразование: преобразований
преступить: преступила
при: при
привлечь: привлечены
придерживаться: придерживалась
придумывать: придумывали
приказ: приказ, приказом
приказываться: приказывалось
прикрепляться: прикреплялась
прикрытие: прикрытия
применять: применяемым, применять
пример: примеру
принадлежность: принадлежность
принудить: принужденные
приобрести: приобрели
приоритетный: приоритетным
присоединиться: присоединились
притон: притонов
прифронтовой: прифронтовой, прифронтовые
причина: причине
проведение: проведение, проведения
проверка: проверке, проверки
проверять: проверяли
провести: проведенного
провизионный: провизионных
проводить: проводили
производить: производить
производиться: производился
произношение: произношении
происхождение: происхождения
простой: простыми
против: против
противник: противника
противодействие: противодействию
прошедшее: прошедших
публичный: публичных
пункт: пунктам
путь: путях
пытаться: пытались
пять: пяти
работа: работ, работе, работу, работы
работать: работавшие
работник: работникам
раз: раз
разведка: разведки
разведывательный: разведывательно, разведывательной, разведывательному, разведывательные, разведывательный, разведывательным, разведывательных
развернуть: развернули, развернуты
развёртывание: развертывание
различный: различных
размещаться: размещались
разоблачение: разоблачению
разоблачить: разоблачили
район: районы
ранний: ранних
распознать: распознать
распорядиться: распорядился
расследование: расследований
рассматриваться: рассматривается
расстрел: расстрел, расстрела
револьвер: револьвера
регистрация: регистрацию
регулярно: регулярно
режим: режим
республиканский: республиканских
ресурс: ресурс, ресурсов
речевой: речевую
ржаветь: ржавеющие
ркк: ркка
родина: родина
розыск: розыск
розыскной: розыскных
роль: роль
рубль: рублей
руководство: руководства
румыния: румынии
рф: рф
ряд: ряды
рядовой: рядовые, рядовых
с: со
сo: сo
савельев: савельева
самара: самара
самарский: самарский
самый: самых
сбежать: сбежавших
сбор: сбор, сбора
сведение: сведения
свет: свете
свой: своих
свыше: свыше
связь: связи
сдаться: сдавшихся
себя: себе, себя
север: север
северо: северо
сеть: сетью
система: система, системы
ситуация: ситуации
склад: складов
скрепка: скрепки
следственный: следственные, следственных
слово: слова, слово
служба: службам, службы
случай: случаев, случаях
смерть: смерть
смерш: смерш, смерша
смысл: смысле
собственный: собственной, собственных
событие: событий
советский: советские, советский, советских, советского, советской, советском
совместный: совместной
современность: современности
современный: современных
согласно: согласно
содержатель: содержатели
создаваться: создавались
солдат: солдат, солдаты
сообщение: сообщения
соответствующий: соответствующие
сосредоточить: сосредоточить
состав: состав, состава, составе
сотрудник: сотрудники
социально: социально
союз: союз, союза
спецслужба: спецслужб, спецслужбам, спецслужбы
список: список
способствовать: способствовали, способствовать, способствует, способствующих
сразу: сразу
среди: среди
срыв: срыв
ссср: ссср
сталин: сталина
стальной: стальные
станция: станции
старание: старании
старик: стариков
старший: старшим
стать: стали, стало
статья: статье
степень: степени
столкнуться: столкнулся
сторона: стороны
страна: страны
стратегия: стратегии, стратегию
стрелковый: стрелковых
строение: строений
строй: строем
студент: студент
существование: существовании
существовать: существовали
существующий: существующий
сыграть: сыграла, сыграли
табель: табель
такой: таких
тактика: тактику
талый: тало
тарок: тарока
твёрдый: твердым
тем: тем
территориальный: территориальными
территория: территории, территорию, территориях
террорист: террористов
террористический: террористических
тип: типа
только: только
тот: тех, том
трагичный: трагичных
требовать: требующими
третий: третьего
трибунал: трибуналы
трус: трусов
тыл: тыл, тыла, тылу
тыловой: тыловые
тысяча: тысяч
уборщица: уборщицам
угроза: угроз, угрозами
удаться: удалось
удачный: удачных
удостоверение: удостоверений
уже: уже
уйти: уйти
указание: указании
указывать: указывал
укрытие: укрытия
уличить: уличенных
умело: умело
университет: университета
уникальный: уникальными
управление: управление, управлений, управления
уровень: уровнем
урок: урока, уроком
усиление: усилениях
условие: условиях
услышать: услышав
успех: успеху
устанавливать: устанавливали
устойчивость: устойчивости
устраиваться: устраивались
утверждать: утверждать
участвовать: участвовали
участник: участников
учащение: учащением
учреждение: учреждения
филиал: филиал
финляндия: финляндии
форма: форма
формирование: формировании
формироваться: формировавшиеся
фотография: фотографии, фотография
фронт: фронта, фронтах, фронте, фронтов
фундамент: фундаментом
характер: характер
хва: хва
ход: ход
хозяйственный: хозяйственных
хорошо: хорошо
цель: целей, цели, цель, целью, целях
часто: часто
частый: чаще
часть: частей, части, частям, частях
человек: человек, человека
через: через
численность: численностью
чистый: чистые
член: членов, члены
что: чего, что
шибболет: шибболета
широко: широко
шифр: шифра
школа: школ, школах
шпион: шпион, шпиона, шпионам, шпионов
шпионский: шпионской
шрифт: шрифт
штаб: штабов
шёлковый: шелковая
щит: щит
электронный: электронный
этап: этап, этапах, этапе
этнический: этническую
это: это, этого
этот: эти, этой, этому, этот
эффективность: эффективность
эффективный: эффективному
южный: южного
юлия: юлия
являться: являющихся
январь: января
ярко: ярко
яуза: яуза
