авторитарный: авторитарных
адаптироваться: адаптируясь
акт: актах
активизация: активизация
активный: активная
акцент: акценты
алина: алина
альтернативный: альтернативную
анализ: анализ, анализу
аннотация: аннотация
армия: армии
безоговорочный: безоговорочное
безопасность: безопасности
взаимодействие: взаимодействия
вид: вид, видов, виду
включать: включает, включающая
включая: включая
влиять: влияющие
вместе: вместе
военкомат: военкомат
военнослужащий: военнослужащим, военнослужащими, военнослужащих
военный: военная, военной, военную, военный, военных
возлагаться: возлагается
возможно: возможно
воинский: воинская, воинский, воинских, воинского, воинской
война: войны
вообще: вообще
вооружение: вооружения
вооружённый: вооруженные, вооруженных
вопрос: вопросы
вот: вот
время: времени, время
всё: все
выбор: выбора
выбрать: выбрать
выполнение: выполнения
выразить: выражено
год: год, года, лет
государственный: государственного, государственной, государственный
государство: государства
гражданин: граждан, гражданами
гражданский: гражданских, гражданского, гражданской, гражданскую
гуманитарный: гуманитарный
дать: данная
демократический: демократические
демократия: демократии
деренский: деренский
до: до
договор: договорами, договорах
долг: долг, долга
достаточный: достаточные
достигнуть: достигших
другой: другие, других
есть: есть
жизнь: жизни
задача: задач
закон: закон, законах, законе, законом, закону
законодательство: законодательства, законодательстве
закрепить: закреплено
заметка: заметки
запас: запасе
затем: затем
защита: защите, защиты
защищать: защищают
здоровье: здоровья
знак: знаки
знание: знаний
значимый: значимая
значительный: значительным
идеология: идеологии
из: из
изменение: изменения, изменениям
инженерный: инженерный
институт: институт, институты
интерес: интересы
исключение: исключение
исполнение: исполнения
исторический: исторического
история: история
как: как
качество: качеств
ключевой: ключевые
конституция: конституции
контрактник: контрактников
контроль: контроль
который: которые, которых
крайний: крайней
кудашкина: кудашкин
курс: курса
литература: литературы
личностный: личностна
международный: международными, международных
механизм: механизмах
миротворческий: миротворческих
мнение: мнением
молодой: молодой
монография: монография
морально: морально
мочь: может
мужской: мужского
назаренко: назаренко
например: например
настоящий: настоящее
научный: научная
находиться: находится
начало: начала
начальный: начальных
начинаться: начинается
нельзя: нельзя
необходимо: необходимо
необходимость: необходимости
несмотря: несмотря
нижнетагильский: нижнетагильский
нижний: нижний
новый: новые
нормативный: нормативных
обзор: обзор
область: области
оборона: обороны
образование: образования
образовательный: образовательных
обращение: обращении
общеобразовательный: общеобразовательной
общественный: общественной
общество: общества, общество
обществознание: обществознание
общий: общего
объяснение: объяснения
обязанность: обязанности, обязанность
обязательный: обязательна, обязательная
ограничить: ограничена
одежда: одежды
он: его
она: ее, она
они: их, ним
операция: операциях
определяться: определяется
определённый: определенных
организация: организации, организаций, организация
основа: основам
основываться: основываются
особенность: особенностей, особенности
особый: особую, особый
от: от
отечество: отечества
отличаться: отличается
отсрочка: отсрочки
педагогический: педагогический, педагогического
период: периода
петербург: петербург
писать: пишет
под: под
подготовка: подготовка, подготовки, подготовку
поддержка: поддержку
подлежать: подлежать, подлежит
подразумевать: подразумевает
подчинение: подчинение
позволять: позволяют
позиция: позиции
пол: пола
политический: политической
полностью: полностью
положение: положение
получение: получение, получения
посвятить: посвящена
поскольку: поскольку
после: после
последующий: последующей
постановка: постановку
почётный: почетной
право: прав, праве, право
правовой: правового
правозащитный: правозащитных
практика: практика
предназначить: предназначены
предполагать: предполагает
представление: представлении
преобразование: преобразование, преобразований, преобразования
претерпевать: претерпевают
при: при
привести: привели, привело
призыв: призыву
применение: применение
пример: примере
принадлежать: принадлежит
принятие: принятие
присяга: присяги
проводиться: проводится
произойти: произошедших
происходить: происходят
протяжение: протяжении
профессионализм: профессионализм
профессионально: профессионально
профессиональный: профессионального, профессиональной
профиль: профиля
проходить: проходить, проходят
прохождение: прохождения
процесс: процессах
психологический: психологических
работа: работа, работе
радиоэлектроника: радиоэлектроники
различие: различия
рамка: рамках
рассматриваться: рассматриваются
рассмотрение: рассмотрении, рассмотрению
регламентация: регламентацию
регулирование: регулирования
ред: ред
российский: российского, российской
россия: россии
рост: рост
рф: рф
санкт: санкт
сдвигать: сдвигающими
себя: себя
сергеевич: сергеевна
сила: сил, силы
следить: следят
следовать: следует
слово: слова
служба: служба, службе, службу, службы
случай: случай
соблюдение: соблюдением
собрание: собрание
современный: современной, современных
согласиться: согласиться
согласно: согласно
создание: создание
соответствие: соответствии
соответствовать: соответствующей
социально: социально
социальный: социального, социальные, социальный
социокультурный: социокультурной
социологический: социологический
союзник: союзников
список: список
способствовать: способствуют
среднее: среднего
срок: срок
ст: ст
стажировка: стажировкой
стандарт: стандартов
стать: стали
статья: статье, статья
степенко: степенко
степень: степени
стремление: стремление
структура: структур, структуре
студент: студент
сфера: сферах
тагил: тагил
такой: такие
тем: тем
тенденция: тенденций
теория: теория
территория: территории
тога: тогу
только: только
тот: том
трансформироваться: трансформировалась
требовать: требует
узяновый: узянова
уменьшение: уменьшению
университет: университета
урегулировать: урегулированы
условие: условия
участие: участие
учитывать: учитывать
учреждение: учреждениях
учёный: ученой, ученые
учёт: учет
фактор: факторами, факторы
факультет: факультет
федеральный: федеральном, федеральному, федеральный, федеральным
федерация: федерации
фз: фз
физический: физической
филиал: филиал
форма: форме, форму
формирование: формированием
функционирование: функционировании
функция: функция
целое: целом
центр: центр
часть: частей
человек: человек
череповец: череповец
череповецкий: череповецкий
черта: черт
число: числе
что: что
эволюционировать: эволюционирует
экономический: экономической
это: это
этот: этих
эффективность: эффективность
юридический: юридический
