адаптаци: адаптации
актив: активного
активн: активно, активному
активност: активностей, активности
алия: алия
анализ: анализ, анализа, анализу
аналитиче: аналитический
антропология: антропология
аспект: аспекты
аспектах: аспектах
ассимиляци: ассимиляции, ассимиляцию
ассимиляция: ассимиляция
благоприятну: благоприятную
благоприятны: благоприятные
богатств: богатства
боле: более
больш: больше
больше: большее
будут: будут
будущ: будущего, будущем
был: был
быстр: быстрой
быт: быть
важн: важно, важных
важност: важности, важность
важну: важную
введени: введение
вид: виды
включ: включая
включат: включать
влияни: влияние, влиянию
влияния: влияния
влияют: влияют
влияющи: влияющие
внимани: внимание
внимания: внимания
внутр: внутри
вовлечен: вовлечены
возможност: возможностей, возможности, возможностями
возникат: возникать
возникают: возникают
возникающ: возникающих
возникающи: возникающие
возраст: возраста
воспитани: воспитание, воспитании, воспитанию
воспитания: воспитания
воспринимат: воспринимать
восприяти: восприятие
вредн: вредно
времен: времени
время: время
все: все
втор: второй
выбор: выбор, выборе
вывод: выводы
выделен: выделены
вызват: вызвать
вызов: вызовами, вызовов, вызовы
вызыват: вызывать
выполнения: выполнения
выработат: выработать
выработк: выработке
выражат: выражать
выступают: выступают
выявит: выявить
где: где
глубоки: глубокий
государств: государства
государственн: государственный
грамматическ: грамматической
давлени: давление, давлением
даж: даже
дальнейш: дальнейшем
данн: данная, данной, данных
дел: дел
демонстрируют: демонстрируют
дет: детей, дети
детств: детства
детьм: детьми
детям: детям
должн: должны
домаш: домашней
домашн: домашних
доминировани: доминирование
доминирования: доминирования
доминирует: доминирует
доминируют: доминируют
доминирующ: доминирующего, доминирующем, доминирующему
достаточ: достаточного
достаточн: достаточной
доступ: доступ
друг: других, другой
други: другие
другу: другую
друз: друзей
его: его
ежедневн: ежедневное
ельжановн: ельжановна
есбусинов: есбусинова
жизн: жизни
забвени: забвению
забывается: забывается
забыват: забывать
зависит: зависит
задач: задачей
заняти: занятий
занятост: занятости
запас: запаса
запрет: запрета
затруднения: затруднения
звук: звуки
знан: знаниями
знани: знание
значени: значение
значимост: значимости, значимость
значительн: значительное
иван: иванов
игр: игр, игры
играют: играют
идентичност: идентичности, идентичность
из: из
изменения: изменения
изучени: изучению
изучения: изучения
имеет: имеет
имет: иметь
имеют: имеют
иногд: иногда
иностранн: иностранных
интерес: интерес
интернет: интернет
интонаци: интонации
информаци: информации
использовани: использование, использовании, использованию
использования: использования
использоват: использовать
использоваться: использоваться
используется: используется
испытывают: испытывают
исследования: исследования
истори: истории
источник: источники
их: их
как: как, каких
каки: какие
кафедр: кафедра
качеств: качестве
ключев: ключевой, ключевым
ключеву: ключевую
ключевы: ключевые
книг: книг
когд: когда
коллег: коллег
коммуникаци: коммуникации
коммуникационн: коммуникационных
коммуникационны: коммуникационные
контекст: контекст, контексте
контекстах: контекстах
конул: конул
конфликт: конфликтом
котор: которая, которой, которыми
которы: которые
критиче: критическое
кром: кроме
культур: культуре, культурного, культуру
культурн: культурная, культурное, культурной, культурный, культурным, культурных
культурны: культурные
культурология: культурология
курс: курса
кыз: кызы
лебед: лебедев
легенд: легенды
лексическ: лексического
лингвистиче: лингвистическая
лингвистическ: лингвистической
литератур: литературы
личн: личных
материал: материалом, материалы
медицин: медицинский
мене: менее
метод: методы
михайлов: михайлова
младенчеств: младенчества
мнения: мнения
многокультурн: многокультурных
многообрази: многообразие
многообразия: многообразия
могут: могут
модел: моделей, моделями
может: может
молодёжн: молодёжной
момент: моменты
мультиязычи: мультиязычие
мультиязычн: мультиязычная
мысл: мысли
наблюдаться: наблюдаться
навык: навыки, навыков
наиболе: наиболее
народ: народов
народн: народное
наскольк: насколько
наследия: наследия
наук: наук
научн: научный
научны: научные
начинает: начинает
начинается: начинается
начинают: начинают
неадекватн: неадекватное
негатив: негативного
негативн: негативное, негативному, негативным
негативну: негативную
недооцениват: недооценивать
недостаток: недостаток
недостаточн: недостаточное, недостаточной
недостаточност: недостаточности
ней: ней
некотор: некоторых
некоторы: некоторые
ненужн: ненужно
необходим: необходимыми
необходимост: необходимость
неотъемлем: неотъемлемой
неполн: неполное
нов: новым, новых
новы: новые
носител: носителей
оба: оба
обеспечит: обеспечит, обеспечить
обзор: обзор
обобщения: обобщения
образ: образом
образования: образования
образовательн: образовательный, образовательным, образовательными, образовательных
обряд: обряды
обстановк: обстановке
обсуждаются: обсуждаются
обсуждени: обсуждение
обучения: обучения
общенациональ: общенационального
общени: общение
общения: общения
обществ: общества, обществе, общество
общественн: общественных
обыча: обычаи
ограничени: ограничений
ограниченн: ограниченными
ограниченны: ограниченные
один: один
одн: одной
оказаться: оказаться
оказывает: оказывает
оказыват: оказывать
оказывают: оказывают
окружени: окружение, окружении
окружения: окружения
они: они
описательн: описательно
определяет: определяет
определяющ: определяющей
организаци: организацию
оренбург: оренбург, оренбургский
осваиват: осваивать
осведомленност: осведомленности
освоения: освоения
ослабит: ослабить
основн: основная, основной, основными, основных
особ: особого, особое
особенн: особенно
осознават: осознавать
осознани: осознание
осознания: осознания
осознат: осознать
осознают: осознают
от: от
отечественн: отечественной
отказ: отказа
отметит: отметить
отношени: отношение, отношением, отношению
отношения: отношения
отступает: отступает
отсутстви: отсутствие
перв: первыми
первичн: первичных
передается: передается
передач: передача
передаются: передаются
переехавши: переехавшие
переживания: переживания
переход: переход
период: период
перспектив: перспективы
петров: петрова
план: план, плане
повседневн: повседневной, повседневных
повышени: повышению
поддержани: поддержание, поддержанию
поддерживающу: поддерживающую
поддержк: поддержки
подход: подход
позволяет: позволяет
позици: позицию
поколения: поколения
политик: политики
положительн: положительное
получают: получают
понимани: понимание
поощрени: поощрение
поскольк: поскольку
послужил: послужили
потер: потере, потерей, потерю
потребност: потребности
правильн: правильной
праздник: праздники
практик: практик, практики
практически: практические
предлагаются: предлагаются
предложени: предложений
предложения: предложения
предложит: предложить
предпочитат: предпочитать
предпочитают: предпочитают
предпочтениях: предпочтениях
преимуществах: преимуществах
пренебрежитель: пренебрежительного
преобладает: преобладает
преодолени: преодоление
преодоления: преодоления
преподавател: преподаватель
препятстви: препятствием
престижн: престижным
при: при
приверженност: приверженности
привест: привести
призван: призвана
применялис: применялись
пример: примеру
принятия: принятия
причин: причин, причинам
пробл: проблем
проблем: проблема, проблемой, проблемы
проблематик: проблематики
проблемны: проблемные
проведен: проведен
проживания: проживания
пространств: пространстве
просты: простые
процесс: процесс, процессе, процессов
проявляться: проявляться
психология: психология
пут: пути
путаниц: путаницей
работ: работа
развиват: развивать
развити: развитие, развитии, развитию
развития: развития
разговор: разговоры
различн: различным, различных
разн: разным
разны: разные
разработат: разработать
разработк: разработке
ранн: раннего
рассказ: рассказы
рассматривает: рассматривает
рассматривается: рассматривается
рассматриваются: рассматриваются
расхождени: расхождение
расширени: расширении
реалиям: реалиям
ребенк: ребенка
ребенок: ребенок
регулярны: регулярные
результат: результаты
рекомендаци: рекомендации
ресурс: ресурсам, ресурсов
реч: речи
решающу: решающую
решени: решение
решения: решения
род: родного
родител: родителей, родители, родителями
родн: родной, родном, родному, родным
родственник: родственников
рол: роли, роль
российск: российской
руководител: руководитель
рф: рф
сам: самого
сво: своей, своему, свои, своих, свою
свободн: свободно
связанн: связанным, связанных
себя: себя
семей: семейного
семейн: семейной, семейных
семейны: семейные
семь: семье, семьи
семья: семья
семьях: семьях
серьезн: серьезной, серьезным, серьезных
сет: сети
сидор: сидоров
систематизаци: систематизации
ситуаци: ситуации
ситуациях: ситуациях
склонн: склонны
следоват: следовать
слов: слов, слова
сложн: сложной
случа: случае
случаях: случаях
со: со
совместн: совместных
современн: современной
создав: создавая
создают: создают
сообществ: сообществ
соответствующи: соответствующие
сосед: соседей
сохранени: сохранение, сохранении, сохранению
сохранения: сохранения
сохранит: сохранить
социаль: социального
социальн: социальное
социальны: социальные
социология: социология
список: список
способствоват: способствовать
способствует: способствует
способствуют: способствуют
сред: среда, среде, среди, среду, среды
средств: средств, средства, средство
ст: ст
сталкиваться: сталкиваться
сталкиваются: сталкиваются
стат: стать
статус: статус
стать: статье
статья: статья
степен: степень
стимул: стимула
стимулировани: стимулированию
стимулирования: стимулирования
стол: столом
столкнуться: столкнуться
сторон: стороны
стран: страну, страны
стратеги: стратегии, стратегий
стремиться: стремиться
стремятся: стремятся
строит: строить
структур: структур, структуры
студент: студент
существует: существует
счет: счет
считается: считается
считат: считать
тагиров: тагирова
так: таких
таки: такие
таким: таким
творчеств: творчество
теоретически: теоретические
техмур: техмур
тог: того
тольк: только
том: тому
традици: традиции, традиций
традициям: традициям
требует: требует
требуют: требуют
трудност: трудности
убеждени: убеждений
убеждения: убеждения
уделяется: уделяется
уделяют: уделяют
удобств: удобства
уже: уже
укреплени: укреплению
университет: университет
усвоени: усвоению
усвоения: усвоения
усили: усилий
условия: условия
условиям: условиям
условиях: условиях
успешн: успешной
устаревшим: устаревшим
устн: устное
утрачивают: утрачивают
участвуют: участвуют
учет: учетом
учится: учится
учреждени: учреждений
фактор: фактор, факторов, фактором, факторы
федераци: федерации
фигур: фигурами
финансов: финансовых
форм: форме
формировани: формировании, формированию
формируется: формируется
ход: ходе
цел: целом
ценност: ценностей
ценностям: ценностям
ценят: ценят
цифровизаци: цифровизации
част: часто, часть
часть: частью
через: через
член: члены
чтени: чтение
что: что
чувствоват: чувствовать
экспозици: экспозиции
эмиграци: эмиграции
эмиграционны: эмиграционные
эмиграция: эмиграция
эта: эта
эти: эти
этих: этих
это: это, этой
этом: этом
этот: этот
эффективн: эффективных
является: является
являются: являются
язык: язык, языка, языке, языки, языков, языком, языку
языков: языковая, языкового, языковое, языковой, языковом, языковому, языковых
языковедени: языковедение
языкову: языковую
языковы: языковые
