акт: акта, актов, акты
актуальн: актуальными
актуальны: актуальные
анализ: анализ
архив: архивов
баназаров: баназарова
боле: более
борис: борис
брак: браке
будущ: будущем
бурят: бурятский
был: был, была, были, было
важн: важно, важный, важным
важност: важности
велик: великого, великом
вестник: вестник
взяты: взятые
включ: включая
включает: включает
власт: власти, власть
влиял: влияли
влияни: влияние
влияния: влияния
влияниям: влияниям
возникал: возникала
вопрос: вопросов
вопросах: вопросах
времен: времени
время: время
все: всей
всех: всех
вуит: вуит
выделит: выделить
вызывает: вызывает
вылилис: вылились
вышеперечисленн: вышеперечисленное
говоря: говоря
год: года
государств: государства, государстве
государственн: государственной, государственный, государственных
государственну: государственную
граждан: граждан, гражданское
грамотах: грамотах
гуманитарн: гуманитарных
дале: далее
дальнейш: дальнейшего
дальнейше: дальнейшее
дан: данного
данн: данной, данных
дат: дата
даши: дашиев
действующ: действующих
дискусси: дискуссий
документ: документ, документы
документах: документах
дорж: доржи, доржо
друг: других
други: другие
его: его
еди: единого
един: единой
едину: единую
едины: единые
естественн: естественных
жизн: жизни
жител: жителей
журнал: журнал
закон: законов, законы
законодательны: законодательные
законодателя: законодателя
закрепил: закрепил
закреплени: закрепление
закрепленны: закрепленные
заметн: заметно
запад: западом
запис: записи
затруднял: затрудняло
защит: защите
здес: здесь
земц: земцов
значительн: значительное
зрения: зрения
иван: ивана
идентичност: идентичности
из: из
избранн: избранных
имел: имел
имен: имени
инач: иначе
иностранн: иностранным
интенсивн: интенсивными
интерес: интересов
использовани: использование
исследовани: исследование, исследований
истори: истории
историче: исторический
историческ: исторической
исторически: исторические
источник: источники, источников, источником
итак: итак
их: их
как: как
каки: какие
касательн: касательно
кафедр: кафедра
ключевы: ключевые
княжеств: княжества, княжестве
кодифицированн: кодифицированным
контакт: контактами
корн: корни
котор: который
которы: которые
культур: культуры
ленинград: ленинградский
летопис: летописи
литератур: литературы
лучш: лучше
мир: мира
мног: многих
многи: многие
множеств: множество
могл: могли
мож: можем
можн: можно
момент: момент
морунов: морунова
московск: московского, московском
мотив: мотив, мотивов, мотивы
мы: мы
мысл: мысли
найт: найти
наказани: наказаний
наказания: наказания
нам: нам
направления: направления
например: например
населения: населения
наследовани: наследовании
наук: наук
находилас: находилась
национальн: национальной
независимост: независимости
необходим: необходимо
необходимост: необходимость
нескольк: несколько
николаевич: николаевич
норм: норм, нормы
нормативн: нормативных
нормах: нормах
нын: ныне
обеспечит: обеспечить
област: области
обозначаем: обозначаемое
образ: образом
образования: образования
обращения: обращения
обсуждения: обсуждения
общ: общая
общепринят: общепринятых
обществ: общества, обществе
общественн: общественной
обыча: обычаев, обычаи
обычаях: обычаях
обычн: обычных
обязанност: обязанности
обязательствах: обязательствах
одн: одной
однак: однако
оказал: оказал, оказали
он: он
определенны: определенные
определил: определил
осадчук: осадчук
основ: основе, основой, основу
основн: основном, основным, основных
основны: основные
основываяс: основываясь
остается: остается
осталис: остались
отношения: отношения
официальны: официальные
охран: охраны
оценк: оценка
памятник: памятник, памятника
перв: первым
писан: писаным
побудивши: побудившие
побудит: побудить
поведения: поведения
повлиял: повлияли
повышени: повышению
поговорит: поговорить
поддержания: поддержания
подтверждают: подтверждают
позволил: позволило
позволит: позволит
полн: полное
полномочия: полномочия
положения: положения
получит: получить
понят: понять
попытк: попытку
порядк: порядки, порядков
порядок: порядок
последстви: последствие, последствий
последствия: последствия
последующи: последующие
послужил: послужили
потребност: потребности, потребностями
поч: почему
прав: прав, права, право
правил: правила
правления: правления
правов: правового, правовой, правовом, правовых
правову: правовую
правовы: правовые
правопорядок: правопорядок
правоприменени: правоприменение
правосознания: правосознания
правосудия: правосудия
предмет: предметом
представлени: представление
представляет: представляет
представлял: представлял
преступления: преступления
применени: применение
применения: применения
принцип: принципы
принят: принят
приняти: принятие, принятию
причин: причин, причина, причиной, причины
проблем: проблема, проблемы
проиcхождения: проиcхождения
происхождени: происхождение, происхождением
происхождения: происхождения
прописан: прописаны
противодействи: противодействие, противодействием
процесс: процессе
пут: путем
развити: развитие, развитии
развития: развития
разделах: разделах
различ: различного
различны: различные
разнообразн: разнообразных
разработан: разработан
рассматриваются: рассматриваются
рассмотрени: рассмотрение
регулировал: регулировал
регулировани: регулировании
род: рода
росси: россии
рус: руси
русск: русского
рф: рф
ряд: ряд
сборник: сборником
свобод: свобод
свод: сводом
связан: связано, связаны
связанны: связанные
семейн: семейное
сильн: сильно
сист: систему
систем: системы
систематизац: систематизацией
систематизация: систематизация
систематизироват: систематизировать
следстви: следствий
следующи: следующие
сло: слоев
слов: слова
соб: собой
соблюдени: соблюдению
собственн: собственных
создан: создан
создани: создание, создании
создания: создания
сознания: сознания
сознательн: сознательному
соответствующ: соответствующем
составлен: составлен
составлени: составление, составлению
составления: составления
социальн: социальными
социальны: социальные
список: список
способствовал: способствовал, способствовало
средневеков: средневековой
стабильност: стабильности
стал: стал
стать: статье
стимулировал: стимулировало
стран: страна, стране, страны
стремилас: стремилась
студент: студент
суд: судов
судебник: судебник, судебника, судебнике
существовавш: существовавших
существовал: существовало
существует: существует
существуют: существуют
сфер: сфер
так: такого
таким: таким
теори: теории
тог: того
том: том
тот: тот
точк: точки
траектори: траекторию
требован: требованиями
требования: требования
уголовн: уголовное
удэ: удэ
уже: уже
указывающи: указывающие
укрепил: укрепил
укрепит: укрепить
укреплени: укрепление, укреплением, укреплению
укрепления: укрепления
улан: улан
университет: университет
унифицироват: унифицировать
упоминания: упоминания
управления: управления
упростит: упростить
устанавливал: устанавливал
установил: установил
установит: установить
установлен: установлены
установлени: установление
установления: установления
устойчивы: устойчивые
устоявшихся: устоявшихся
феодаль: феодального
формировани: формирование, формированию
характеристик: характеристика
хроник: хроники
царя: царя
цел: цели
цель: целью
централизаци: централизацию
централизация: централизация
центральн: центральной
церковн: церковных
через: через
чингисович: чингисович
чой: чой
что: что
эпох: эпоху
этап: этапом
это: это
этог: этого
этот: этот
юридиче: юридический, юридических
юридическ: юридического
является: является
