абилевый: абилева
автор: автор, автора, авторов, автором, авторы
азия: азии, азия
академия: академии
алламурат: алламуратов
алламуратов: алламуратова
алматы: алматы
анализ: анализ, анализа
аннотация: аннотация
археолог: археологов
археологический: археологические, археологических
архитектурный: архитектурных
астана: астана
база: база
базари: базари
балка: балки, балок
баночный: баночного
барласа: барласы
бассейн: бассейна
бекстваха: бекствах
бернштам: бернштам, бернштама, бернштамом
битый: битой
блюдо: блюдо
боковой: бокового
больший: больших
большинство: большинства
большой: большое, большой
бревно: бревна
брус: брусьев
булыжник: булыжника
бурх: бурх, бурха
бухара: бухаре, бухары
быт: быт
бытовой: бытовой
быть: был, была, были, было
бюллетень: бюллетень
вазочка: вазочек
варка: варки
век: вв, веке
великолепный: великолепным
величина: величины
верный: верны
вертикальный: вертикальными
верх: верх
верхний: верхние
весьма: весьма
взаимодействие: взаимодействии
вид: вид, виде, видов
видимость: видимости
виднеться: виднеется
владеть: владевших
внутри: внутри
возводить: возводили
возвышение: возвышение, возвышении
возникновение: возникновение
вообще: вообще
вопрос: вопрос
восточный: восточной
востребовать: востребованных
вплотную: вплотную
время: времен, времени
встречаться: встречаются
всё: все
второй: вторая
входить: входит
выделка: выделке
выпуклый: выпуклым
выпускать: выпускаемой
вырабатываться: вырабатываются
выработать: выработанные
высокий: высока, высокие, высокой, высочайшей
высоко: высоко
высококачественный: высококачественную
высушивать: высушивают
высушить: высушенная
выходить: выходит
выше: выше
гадло: гадло
гардань: гардани
где: где
генштаб: генштаба
главный: главным
гладкий: гладкой
глазуровать: глазурованная, глазурованной
глина: глина, глиной, глину, глины
глинобитный: глинобитное, глинобитном, глинобитные, глинобитным
глиняный: глиняной, глиняную, глиняных
говорить: говоря
гончар: гончар
гончарный: гончарного, гончарное, гончарном, гончарных
гончаров: гончаров
гончарство: гончарства
горизонтальный: горизонтальные
горный: горного, горном, горный, горных
горшков: горшков
горшок: горшки
градостроительство: градостроительство
гребенка: гребенки
грубый: грубой
группа: группы
данный: данное
дастархан: дастарханы
дать: дан
декун: декуна, декуне
делать: делающие
делаться: делалась
дело: дела, дело
день: дней
дерево: дерева
деревянный: деревянных
деятельность: деятельностей
дно: дном
до: до
дойти: дошедшее
долина: долине
дом: домом
домашний: домашнюю
дониша: дониш
древний: древней, древнейших, древний, древних
другой: другие, других
душанбе: душанбе
европейский: европейских
женщина: женщины
жердь: жерди, жердями
жизнь: жизни
жилище: жилища, жилище
журнал: журнале
завоевание: завоевания
закавказье: закавказья
законченность: законченностью
замок: замки
занимать: занимает
заниматься: занималась, занимаются
затем: затем
звук: звук
здесь: здесь
земля: землю, земля
зеравшан: зеравшана
зимний: зимние
зимовка: зимовках
зимой: зимой
значительно: значительно
значительный: значительное
ибадуллаев: ибадуллаев, ибадуллаевым
идти: шло
из: из
изготовление: изготовления
изд: изд
издавать: издают
издавна: издавна
издалёка: издалека
издать: изданы
изделие: изделии, изделий
изначально: изначально
изразец: изразцы
изучение: изучение, изучением, изучению, изучения
изучить: изучена, изученным, изучено, изучены, изучив, изучившего
изящество: изяществом
иметь: имела, имеют, имеющее
империя: империи
иначе: иначе
иной: иной
информация: информация
искусный: искусной
искусство: искусства, искусство
искусствоведческий: искусствоведческий
исмаил: исмаила
использовать: использована, использованы
исследование: исследование, исследовании, исследованию, исследования
исследователь: исследователей
исследовать: исследовавшего, исследуемая
историк: историков
историко: историко
историография: историография
исторический: историческая
история: истории, историю, история
источник: источника
источниковедческий: источниковедческая
к: ко
каждый: каждый
казахстан: казахстан, казахстана
как: как
какой: какого
камень: камней
каркас: каркас, каркаса
карлук: карлуки
кас: каса
катакомба: катакомбах
катыш: катышей
качество: качества, качество, качеством
квартал: кварталы
керамик: керамику
керамика: керамика, керамики
керамический: керамические, керамических, керамического, керамическое, керамическом
кирпич: кирпича
кисляков: кисляков, кислякова
классификация: классификации
класть: клали
ключевой: ключевые
козёл: козел
коллективизация: коллективизации
композиция: композициям
конец: конце, концу
конструкция: конструкции
который: которая, которого, которой, которые, которым, которых
котёл: котлов
кочевник: кочевников
край: края
крайний: крайней
красный: красным
красота: красоты
критерий: критерии
круг: круга, кругу
круглый: круглое
крупный: крупные
крынка: крынок
крыша: крыши
кувшин: кувшины
культ: культ
культура: культура, культуры
кума: кума
кухонный: кухонной
кыргыз: кыргыз
кыргызский: кыргызского
кыргызстан: кыргызстана
лента: лент
ленточный: ленточной
лепить: лепили
лепка: лепки
лепной: лепная
лечебный: лечебные
литература: литературой, литературы
лишь: лишь
мавераннахра: мавераннахре
мавзолей: мавзолей
маленький: меньше
мало: мало
мастер: мастера
мастерский: мастерскими
материал: материал, материалам, материалами, материалов, материалом, материалы
между: между
мера: мере
местность: местности, местность
местный: местного, местным
место: место
металлический: металлический
метод: методы
методический: методической
мнение: мнению
многий: многих
можно: можно
монгольский: монгольского
моск: моск
москва: москва
музей: музеев, музея
муса: муса
мусаипович: мусаиповна
надо: надо
название: название
назым: назым
наиболее: наиболее
найти: найденных
наклонный: наклонными
намного: намного
направление: направлении, направлениям
например: например
народ: народа, народов
наряду: наряду
население: населения
настилаться: настилался
насыпаться: насыпалась
наука: наук, науки
научно: научно
научный: научной
находка: находках, находки, находок
национальный: национального, национальное
начало: начале, начало
наш: наших
невысокий: невысокий
неглазированный: неглазированных
некоторый: некоторые, некоторых
необходимо: необходимо
неповторимый: неповторимые
неравномерный: неравномерный
несколько: нескольким, несколько
несмотря: несмотря
нечётный: нечетное
низ: низу
ничтожный: ничтожную
носить: носит
о: об
оазис: оазисе
обжиг: обжиг, обжига, обжиге
обжигательный: обжигательной
обильный: обильным, обильных
обладать: обладает
обмазка: обмазкой
обмазываться: обмазывался
образ: образом
образец: образцы
объективный: объективные
обыкновенный: обыкновенная, обыкновенную
обычно: обычно
один: одним
около: около
округа: округу
окружающий: окружающей
он: его, он
она: ее
они: их, ним, них
описать: описана
описывать: описывает, описывая
опорный: опорные, опорными
определённый: определенном, определенных
опубликовать: опубликованные, опубликованных, опубликовано
орех: ореха
орнамент: орнаментом
оседлый: оседлого
основа: основе, основой, основу
основание: основании
основной: основные
особенно: особенно
особенность: особенности
особо: особо
оставаться: остаются
от: от
отверстие: отверстие
отдельный: отдельных
отличаться: отличаются
отличие: отличие
отметить: отметить
относиться: относящихся
отношение: отношений, отношения
оттиск: оттисков
офицер: офицерами
охарактеризовать: охарактеризованы
очаг: очаг
памир: памиров
пахс: пахсы
первый: первые
перед: перед
пережить: пережившее
перекрытие: перекрытия
перемешать: перемешанной
период: период
перспективный: перспективных
петербургский: петербургского
печь: печи
пиала: пиала
писать: пишет
пища: пищи
плохой: хуже
поверхность: поверхности, поверхность
поверье: поверьям
повсеместно: повсеместно
погребальный: погребального
под: под
поддержание: поддержания
подтверждать: подтверждают
подход: подход, подхода
подходить: подходила
подчеркнуть: подчеркнуть
подытожить: подытожить
позиция: позиции
показать: показало
покрываться: покрывалась, покрывались
пол: пол
полихромный: полихромные
половина: половина
получать: получают
поляк: поляков
поляков: полякова, поляковым
помещение: помещений
поперечный: поперечных
пополам: пополам
попытаться: попыталась
поражать: поражало
посвятить: посвящена
поселение: поселении, поселения, поселениях
поскольку: поскольку
после: после
последовательность: последовательности
пособие: пособие
постройка: постройки
постукивание: постукивания
посуда: посуда, посудой, посуду, посуды
потом: потом
потому: потому
потребность: потребность
поход: походом
почвенный: почвенную
появляться: появляются
практика: практики
прах: прах
превосходный: превосходного
предварительно: предварительно
предмет: предметами
предполагать: предполагает
представить: представлена
представлять: представляет, представляющие
преимущественно: преимущественно
преобладать: преобладают
претендовать: претендует
при: при
прибавление: прибавление
привести: приведены, привели
привилегия: привилегией
привлечение: привлечением
приготовление: приготовлением
признак: признаков
прикладной: прикладное
применение: применение
пример: примере
примитивный: примитивная
принадлежность: принадлежность
проанализировать: проанализировали
проблема: проблеме
проблемный: проблемно
провести: проведен
проводить: проводивших
производство: производства, производстве, производство
промежуток: промежутки
промысл: промыслов
пропитание: пропитания
простой: простым
процветание: процветания
процесс: процессе
прочно: прочно
прочность: прочностью
публикация: публикаций
путешественник: путешественников
путешествнник: путешествнниками
пятно: пятном
пять: пяти
работа: работа, работами, работе, работы
равнина: равнине
развивающийся: развивающейся
развитие: развитие, развитии, развитию, развития
развитой: развито, развитые
раздробить: раздроблена
различный: различной
размочить: размоченная
разнообразный: разнообразный
район: районах
ранна: ранной
раннесредневековый: раннесредневековые
раскопка: раскопок
расписной: расписную
располагаться: располагались
распространение: распространение
рассмотреть: рассмотрен
растительность: растительностью
расширяться: расширяющееся
расщепить: расщепленные
редко: редко
река: реки
ремесленный: ремесленных
ремесло: ремесел, ремесла, ремесло
республика: республики
российский: российской
руководитель: руководитель
русский: русских
ручной: ручной, ручным
саман: самана
саманя: самани
самый: самым
сапаллинский: сапаллинской
сапаллитеп: сапаллитепе
сведение: сведения
сверху: сверху
свидетельствовать: свидетельствует, свидетельствуют
свидетельствующий: свидетельствующей, свидетельствующую
свой: своего, своей, свои, своих
свойство: свойства, свойствами
сдать: сдал
сделать: сделавшей, сделанная
себя: себе, собой
сельский: сельские
серый: серых
символ: символам
системный: системного, системным
скудный: скудной
славиться: славились
следовательно: следовательно
следующий: следующие
слепить: слепленных
слово: слова
сложение: сложения
сложить: сложенном
слой: слой
служба: службы
служить: служили, служит
снабжать: снабжавших
снаружи: снаружи
сначала: сначала
совершенство: совершенстве
советский: советская, советский
современник: современников
согда: согда
согде: согде
согдийский: согдийская
создавать: создающих
создать: создали
солнце: солнце
солома: соломой, соломы
сооружение: сооружений, сооружения
составлять: составлял
сосуд: сосуда, сосудов, сосуды
сохраниться: сохранилась
спб: спб
список: список
спокойствие: спокойствия
способ: способом
сравнительно: сравнительно
среди: среди
средневековый: средневековой
средний: средней, средняя
сср: сср
ссср: ссср
ставить: ставили
станковый: станковая
становление: становления
старый: старейшего
статус: статус
стать: стали
статья: статье, статья
стена: стен, стены
стенка: стенки
стилистический: стилистического
стоить: стоит
столб: столбами, столбы
столица: столице
страна: стран, странам
строитель: строители
строительный: строительным
строительство: строительстве
строить: строить
суфа: суфа
существовать: существовавших, существовали, существовало
существующий: существующими
сфера: сфер
сырой: сырым
сырцовый: сырцового
таджик: таджики, таджиков
таджикистан: таджикистана, таджикистане
таджикский: таджикского
такой: такие, таким, таких
тандыр: тандыры
тараз: таразе
ташкент: ташкент
ташкентский: ташкентском
тема: тема
температура: температуре, температурой
тень: тенью
тесный: тесном
техника: техника, технике
технически: технически
технический: техническом
технологический: технологических
технология: технология
тип: типа
толстой: толстой
толщина: толщину
только: только
тонкий: тонкие
тополь: тополя
торговый: торгово, торговые, торговых
тот: та, той, том
традиционный: традиционная, традиционном, традиционный
требовать: требует
тростник: тростника
туземец: туземцев
турсуновый: турсунов, турсунова
тюрк: тюрки
тянить: тянь
убогий: убогие
угловой: угловыми
углубление: углубление
удерживать: удерживает
уже: уже
узбекистан: узбекистана
узбекский: узбекской
указанный: указанная
уклад: уклад, укладе
укладывать: укладывали
укреплять: укрепляли
уложить: уложенные
уна: ун
университет: университета
упоминать: упоминает
употребление: употреблением
установить: установить
устойчивый: устойчивые
устояться: устоявшимся
устраиваться: устраивается
утварь: утварь
утверждать: утверждает, утверждают
учебный: учебное
фан: фан
февраль: февраль
феодализм: феодализма
ферганский: ферганской
форма: форм, формам, формы
функциональный: функциональная, функциональную
характер: характер
хива: хиве
хингоу: хингоу
хисор: хисор
ход: ходе
хозяйство: хозяйстве
хорезм: хорезм
хороший: лучше
храм: храмы
хронологический: хронологический, хронологического, хронологической
хум: хумов, хумы
целебный: целебными
целенаправленный: целенаправленные
целое: целом
центр: центра, центров, центры
цоколь: цоколе
частность: частности
часто: часто
черепок: черепка
честность: честности
число: числе, число
что: что
чёрный: черная
чёрточка: черточек
шаг: шаги
шаня: шаня
шерабад: шерабаде
шерабадский: шерабадская, шерабадских
шесть: шести
широкий: широким, широкое
шиш: шишов
шишкин: шишкина
шишов: шишова
школа: школа
щедрость: щедрости
эволюционный: эволюционного
этап: этапы
этнограф: этнографа, этнографов
этнографический: этнографические, этнографическими, этнографическое
этнография: этнография
это: это, этого
этот: этих, этот
юг: юг
южный: южного, южных
юлдошева: юлдошев
являться: является, являющееся
яйцевидный: яйцевидной
якуб: якубов
якубова: якубова
ямка: ямок
январь: январь
