автор: автор, автора, авторов, автором
автореферат: автореферат
авторство: авторства
агитация: агитации
агрессор: агрессорам
ад: ад
акад: акад
активизация: активизация
активно: активно
активность: активности
актуальный: актуальным
акцент: акцент
александр: александр
александров: александров
алексей: алексей, алексея
анализ: анализ
армия: армии
артист: артистам
аспект: аспекте, аспекты
аспирант: аспирантов
баллада: баллада
баталия: баталиям
батюк: батюк
без: без
безграничный: безграничную
белорусский: белорусский
берггольц: берггольц
бескорыстный: бескорыстным
бессмертный: бессмертен
биться: бьется
благо: благо
благодаря: благодаря
блантереть: блантер
блокнот: блокноты
богословский: богословский
боец: бойцов
более: более
бондарев: бондарев
борьба: борьбе, борьбы
будни: будней
будущее: будущим
будущий: будущему
бурковский: бурковский
быков: быков
быть: будь, был, была, были, было
важность: важность
важный: важнейшей, важнейшие, важных
валентина: валентине
валерий: валерий
василевский: василевской
василий: василий
васильев: васильев
вдохновлять: вдохновляли
веймарна: веймарн
великий: великая, великой
вернуться: вернусь
весь: всю
взаимоотношение: взаимоотношений
взгляд: взгляд
вид: виде
визуализировать: визуализировать
викторович: викторович
вклад: вклад, вкладом
включая: включая
влияние: влияние, влияния
вложить: вложить
вместе: вместе
внести: внесла
внимание: внимание, внимания
вновь: вновь
вносить: вносил
военнослужащий: военнослужащими
военный: военного, военное, военные, военный, военными, военных
возбуждение: возбуждения
возвращаться: возвращались
возникнуть: возникли
возрасти: возросло
воин: воинов
воинский: воинского
война: война, войне, войну, войны
вокальный: вокально
вокзал: вокзал
волгоград: волгоград
волнующий: волнующих
вооружение: вооружений
ворожок: ворожка
воспевать: воспевающие
воспитание: воспитание, воспитании, воспитания
воспитывать: воспитывая
восприятие: восприятие
воспроизводить: воспроизводят
восьмой: восьмая
впервые: впервые
враг: врага
время: времена, времени, время
вроде: вроде
всероссийский: всероссийской
всё: все, всё
второй: вторая, второй
входить: входит
вы: вам
выдающийся: выдающейся, выдающиеся, выдающийся, выдающихся
выделить: выделить
выделяться: выделяется, выделяются
выдержка: выдержке, выдержкой
выпустить: выпущенное
выражать: выражать
выражение: выражения
вырисовываться: вырисовываются
выступать: выступают
выступить: выступил
галынина: галынин
где: где
герман: германа
героизм: героизм, героизма, героизму
героический: героическим, героическими
геройский: геройских
гладкий: гладких
глаз: глазами
глубина: глубину
глубокий: глубокие, глубоким, глубокое, глубоком
год: гг, годами, годов, годы, лет
голод: голода
город: города
государственный: государственного, государственный
гражданин: граждан, гражданина
григориевич: григорьевич
гроссман: гроссман
даже: даже
далее: далее
датировать: датированная
двадцать: двадцать
дебютировать: дебютировавшая
делать: делает, делают
дело: дел, деле, дело
демонстрировать: демонстрируют
день: день, дней
десятилетие: десятилетия
детство: детство
деяние: деяниями
деятель: деятелей
деятельность: деятельности, деятельность
дизайн: дизайна
дилогия: дилогией
дис: дис
до: до
добро: добро
доброта: доброте
довольно: довольно
доклад: доклады
документальный: документальные, документальных
дополнение: дополнение
достижение: достижений
другой: другие, другими
дух: дух, духа
духовно: духовно
духовный: духовной
дыхание: дыхания
единый: единую
ещё: ещё
её: её
ждать: жди
женщина: женщине
жестокость: жестокостью
жизненно: жизненно
жизненный: жизненные, жизненных
жизнь: жизни, жизнь
житель: жителей
журавль: журавли
журнал: журнал
журналист: журналист
забытый: забыт, забыто
завершение: завершения
завершить: завершена, завершенная
завоевать: завоевало
заметка: заметки
заметный: заметна, заметной
записка: записки
заслуга: заслуг
заслуживать: заслуживает
затем: затем
затрагивать: затрагивали
звучать: звучали
землянка: землянка
зингер: зингер
знать: знали
значимость: значимости, значимость
значимый: значимыми, значимых
значительный: значительное, значительный, значительных
зритель: зрителей, зрителю
иваново: иваново
играть: играет
идеологический: идеологического
идея: идею
из: из
изд: изд
издание: издание, изданий
изображение: изображениях
изобразительный: изобразительное
израиль: израиле
иллюстрация: иллюстрациями
иллюстрировать: иллюстрируют
илья: илья, ильёй
именно: именно
импровизированный: импровизированных
имя: имена
индустрия: индустрии
инструмент: инструмент, инструментом
интимность: интимностью
иркутск: иркутск
иркутский: иркутский
искусство: искусства, искусстве, искусство
искуство: искуство
использование: использование
испытание: испытаний, испытаниях
исследователь: исследователей
истина: истину
исторический: исторический, исторических, исторической
история: истории, история
источник: источник, источником
итог: итоги
каждый: каждого
как: как
калатозов: калатозова
кандидат: кандидата
картина: картин
картинка: картинка
качество: качеств, качеству
кинематограф: кинематограф, кинематографа
кинематографический: кинематографические
кино: кино
киножурнал: киножурналов
киноискусство: киноискусстве, киноискусство
кинолента: кинолент
кинопрограмма: кинопрограммах
кинопроизведение: кинопроизведения
кинорассказ: кинорассказах
киноустановка: киноустановок
классика: классикой
ключевой: ключевую, ключевые, ключевым, ключевых
книга: книга
когда: когда
количество: количество
коллективный: коллективной
композитор: композиторов, композиторы
конец: конца
константин: константин
контекст: контексте
конференция: конференции
который: которая, которое, которые, который, которых
красный: красной
кронштадт: кронштадта
крыло: крылья
кто: кто
культура: культура, культуре, культуры
культурный: культурное
купюра: купюрам
курский: курского
легко: легко
ленинград: ленинграде
ленинградский: ленинградская
лента: лент, ленты
леонидов: леонидова
лететь: летят
летие: летию
либест: либест
лирика: лирика
лирический: лирических
лист: листов
литература: литература, литературе, литературу, литературы
литературный: литературное, литературные, литературный
личность: личности
личный: личные, личных
лишь: лишь
любимый: любимой
любовь: любви, любовь
магистрант: магистрантов
масштаб: масштабу
материал: материале, материалы
международный: международной
менее: менее
метко: метко
минин: минин
мир: мир
мирный: мирному
мировой: мировой
многие: многие
многоаспектный: многоаспектной
многообразие: многообразия
множество: множество
можно: можно
мокроусов: мокроусов
молодой: молодых
молодёжь: молодежи
момент: моменты
моральный: моральные, моральных
мощный: мощный, мощным
мощь: мощью
мпг: мпгу
мужество: мужество, мужеством
музыка: музыка
музыкальный: музыкальная, музыкального
мурадеть: мурадели
мы: мы
над: над
название: названием
наиболее: наиболее
наизусть: наизусть
написать: написанное
напоминание: напоминание
направить: направленным
направление: направлением
народ: народ, народа, народов
население: населения
наслаждаться: наслаждавшихся
наследие: наследие, наследия
настроение: настроения
насыщенность: насыщенностью
наука: наук, наука
научно: научно
научный: научной, научные, научный, научных
находить: находили, находить
нацелить: нацеленные
национальный: национального, национальной
нация: наций
начальный: начального
начать: начав
наш: нашего
нашествие: нашествие
невский: невский
неизгладимый: неизгладимый
ненависть: ненависти
необходимый: необходимое
неотъемлемый: неотъемлемой
непоколебимый: непоколебимой
непосредственно: непосредственно
непревзойдённый: непревзойденной
несмотря: несмотря
нижневартовск: нижневартовск
никто: никто
ничто: ничто
нравственный: нравственного
о: об
обессиленный: обессиленного
обогатить: обогатил, обогащен
образ: образ, образом
обращаться: обращаясь
обращение: обращение
обсуждение: обсуждение
обучаться: обучающихся
обучение: обучении
общий: общую
объединить: объединившая
обычный: обычных
огонь: огонь
ограничиваться: ограничивалось
один: одна, одним, одними, одной, одну
однако: однако
оказывать: оказывали
оккупант: оккупантам
окончание: окончанию
ольга: ольга
он: его
они: им, их, них, они
оперный: оперные
определить: определил
опубликовать: опубликована, опубликованных, опубликованы
опыт: опыт
ориентир: ориентиров, ориентиры
орудие: орудием
осада: осады
осмысление: осмыслению
осмыслить: осмыслен
осмыслять: осмысляющие
основной: основные
основный: основную
особенно: особенно
особый: особого, особой
оставить: оставили, оставлена
осуществить: осуществлен
от: от
отв: отв
отвага: отвагу
ответственность: ответственность
отдаваться: отдавалось
отдельный: отдельное
отечественный: отечественная, отечественного, отечественной, отечественном
отклик: отклик
отличаться: отличаются
отличительный: отличительной
отмечаться: отмечаясь
отпечаток: отпечаток
отражать: отражая
отражение: отражение, отражением, отражения
очень: очень
очерк: очерки
очерковый: очерков
ощущать: ощущал
палата: палата
память: памяти
парень: парень
патриот: патриотами
патриотизм: патриотизма
патриотический: патриотические, патриотический, патриотических, патриотического, патриотическое
первый: первое, первыми
перед: перед
передавать: передавать
передать: передали, передать
переживание: переживаниях
переписываться: переписывались
период: период, периода
пермь: пермь
перо: пером
песенный: песенная
песня: песен, песни, песня
петербургский: петербургский
печурка: печурке
писатель: писатели, писатель
планета: планете
плеханов: плеханова
победа: победе, победу, победы
побуждать: побуждая
повесть: повести, повесть
погонышев: погонышев
под: под
подвергнуться: подвергшись
подвиг: подвигам, подвигами, подвигах
подводить: подводя
поддерживать: поддерживали
поддержка: поддержки
поднимать: поднимал
подрастать: подрастающего
подробно: подробно
подход: подхода
подчёркивать: подчеркивая
пожарский: пожарский
позволять: позволяло
поколение: поколения, поколениям
политический: политического, политической
получить: получившие
попов: попова
популярность: популярность, популярностью
попытаться: попытался
попытка: попытками
посвятить: посвященное, посвященной
посвящаться: посвящается
после: после
послевоенный: послевоенного, послевоенное, послевоенный
последний: последнего
последующий: последующие
посмертно: посмертно
постепенно: постепенно
поступок: поступкам
поэма: поэма
поэт: поэты
поэтесса: поэтесса
поэтика: поэтики
появиться: появился
ппг: ппгу
правый: правое
практический: практической
превратить: превратив
превратиться: превратилась
преданность: преданность
предел: пределами, пределах
предпочтение: предпочтение
представить: представив, представил, представленный
представлять: представляя
предстать: предстал
презрение: презрение
преобладать: преобладали
при: при
приезжать: приезжавшим
призма: призму
признание: признание
призывать: призывая
прикраса: прикрас
проанализировать: проанализировать
проблема: проблема
провести: провели
продолжаться: продолжалось
произведение: произведение, произведений, произведению, произведения, произведениями, произведениях
производство: производства, производстве, производство
произойти: произошла
пройти: прошел
прокофьев: прокофьев
пролить: пролило
промышленный: промышленных
прославиться: прославившаяся
просто: просто
противостояние: противостояния
протяжение: протяжении
прочий: прочих
проявить: проявленные
публика: публике
публикация: публикация, публикациях
путь: путь
работа: работ, работах, работе
работать: работавших
рабочий: рабочих
радиовещание: радиовещание
радуга: радуга
распространяться: распространялись
рассказ: рассказ, рассказов
расти: растет, рос
ред: ред
редактор: редактор
режиссура: режиссуре
родина: родину, родины
роль: роль
роман: роман, романом
россия: россии
рсфср: рсфср
руководство: руководством
русский: русского, русской
рутина: рутине
рф: рф
рядом: рядом
самоотдача: самоотдачу
самый: самые, самым
санкт: санкт
сборка: сборку
сборник: сборник
свет: свет
свой: своей, свои, своими, своих, свой, свою, своё
связанный: связанную, связанные
себя: себя, собой
севастополь: севастополь
сегодня: сегодня
седой: седой
седьмой: седьмая
селина: селина
сердце: сердцах
серов: серовой
сильный: сильное
символ: символом
симонов: симонов
симоново: симонова
симфонический: симфонические
симфония: симфонии
сказать: сказать
сколько: сколько
скорбь: скорбь
следовать: следует
словесность: словесность
слово: слова, словами
сложный: сложные
служить: служит
смерть: смерти
смесь: смесь
смирнов: смирнова
событие: событий, событиями, событиях
советский: советский, советских, советского
совместно: совместно
современный: современного, современных
содержать: содержащий
создавать: создавали
создатель: создатели
создать: созданное, созданные, созданных
сознание: сознания
сократиться: сократилось
солдат: солдат, солдата, солдате
соловьёв: соловьев
соната: соната
сообщение: сообщения
сопровождать: сопровождая
сосредоточить: сосредоточено
составить: составленная
составлять: составляющей
состоять: состоящий
сохранение: сохранении
союз: союза
список: список
способность: способности, способность
способствовать: способствуя
сражаться: сражались
среди: среди
ссср: ссср
ставить: ставящие
сталинград: сталинград
сталинградский: сталинградские
становиться: становясь
старков: старков
стать: ставшие, стала, стали, стало, статей
статья: статье
стимулирование: стимулирование
стихотворение: стихотворения, стихотворениями
стоить: стоит
столкнуться: столкнувшихся
столько: столько
страдать: страдающего
страна: стране, страной
страница: страниц
страшный: страшных
стремиться: стремившимися
строка: строками
студент: студент, студентов
студенчество: студенчества
судьба: судьба, судьбу
суметь: сумел
сурков: суркова
существо: существо
сцена: сценах
счастие: счастье
считать: считали
такой: такие, таким, таких, такого
талант: таланту
тарковский: тарковского
твардовский: твардовского
творец: творцами
творчество: творчестве, творчество
тезис: тезисов
тем: тем
тема: теме, тему, темы
тенденция: тенденции
территория: территории
тесный: тесной
технология: технологий
течь: течет
тип: типа
только: только
тот: те, тех, того, той
точно: точно
трагедия: трагедии
трагический: трагических
традиционный: традиционную
траурный: траурно
треблинский: треблинский
тревожный: тревожного
третий: третья
три: трех
трио: трио
трогательный: трогательными
трубин: трубина
труд: труд, трудах, трудов, труду, труды
трудиться: трудился
трудный: трудные
трусливый: трусливое
тыл: тылу
тыловой: тыловых
тысяча: тысяч
тяжёлый: тяжелых
тёркин: теркин
уверенность: уверенности
увидеть: увидел
уделяться: уделяется
укрепление: укрепление
умение: умению
университет: университет, университета
уникальный: уникальная, уникальный
упрощённый: упрощенном
урок: уроках, уроки
условие: условиях
утратить: утратили
учёный: ученые, учёных
факультет: факультет
фигура: фигурой
фильм: фильмов, фильмы
форма: форма
формирование: формирование, формировании
фортепианный: фортепианная, фортепианное
фрадкина: фрадкин
фронт: фронт, фронтах, фронте
фронтовой: фронтовой, фронтовых
функционировать: функционировало
характер: характера
характеристика: характеристике
хачатурян: хачатурян
холокост: холокоста
хороший: лучших
хранитель: хранители
хренников: хренников
художественный: художественной
ценность: ценностей, ценности
центр: центр
центральный: центральных
чаковский: чаковского
чапаев: чапаев
частность: частности
часть: частью
чей: чьи, чья
человек: людей, человека
человеческий: человеческих, человеческое, человеческую
через: через
черта: чертой, черты
честь: чести
число: число
читатель: читателям, читателями
чкалов: чкалов
чтение: чтений
что: что
чувство: чувств, чувства, чувством
чухрая: чухрая
чёрный: чёрная
шедевр: шедевров
шепитько: шепитько
шешуковский: шешуковских
широкий: широкую
школьник: школьников
шолохов: шолохов
шостакович: шостакович, шостаковича
эконом: эконом
экран: экранах, экранов
электронный: электронный
элемент: элементом
эмоциональный: эмоциональной
эпоха: эпохи, эпоху
эренбург: эренбург, эренбургом
это: это, этом
этот: эти, этих, этой, этому, этот
эффективный: эффективный
эшпай: эшпай
юность: юность
я: меня
являться: является, являются
яркий: яркая, яркими
яркость: яркость
ясный: ясных
