август: августа
авиационный: авиационным
аманович: амановна
анализироваться: анализируется
аннотация: аннотация
армия: армии
артиллерийский: артиллерийским
астрахань: астрахани, астрахань
база: базу
батальонный: батальонные
белый: белых
берег: берег, берега, берегу
беспримерный: беспримерное
битва: битва, битве, битвы
близкий: ближе
боевой: боевую, боевых
бой: бои
более: более
больной: больных
большой: большое, большой
бомбардировка: бомбардировки
бороться: боровшихся
борьба: борьбы
быть: был, были, было
важный: важную
ведомость: ведомости
великий: великой
вероятность: вероятность
вести: вести
весь: весь, всего, всей
витехновский: витехновская
вместе: вместе
водный: водного
военврач: военврача
воениздат: воениздата
военный: военно, военного, военных
возвращаться: возвращающемся
возможность: возможности
возникновение: возникновения
возрастать: возрастал, возрастало
возрасти: возросла
война: войну, войны
волга: волга, волге, волги
волгоградский: волгоградского
воробей: воробьёв
враг: врагом
врач: врачей
время: времени, время
вспышка: вспышек
всё: все
вынуждать: вынуждало
выполнить: выполнить
выполнять: выполнять
выступать: выступало
где: где
германский: германского
героизм: героизма
гигантский: гигантского
главное: главное
год: гг, года
город: город, города, городе
госпиталь: госпиталей, госпитали, госпиталя
госпитальный: госпитальное, госпитальную
государственный: государственное, государственный
грандиозный: грандиозных
гсд: гсд
дальнейший: дальнейшем
данилов: данилов
два: два
двинуться: двинулся
действие: действий
дело: дела
день: день, дней, дня
десятка: десятки
динар: динара
дмитрий: дмитрий
до: до
доклад: доклад
дон: дон
дополнительный: дополнительного
доставка: доставки
достигнуть: достигло
ежедневно: ежедневно
ежов: ежов
железнодорожный: железнодорожная
жизнь: жизни
жилой: жилого
заболевание: заболеваний
задача: задачи, задачу
закончить: закончить
замечательный: замечательные
западный: западного, западных
зачастую: зачастую
здание: здания
здравоохранение: здравоохранения
значение: значение
зона: зоне
играть: игравшие
идти: шла, шли
из: из
издательство: издательств, издательство
иметь: имеет
имя: имени
иногда: иногда
институт: институтов
инструктор: инструкторов
инфекционный: инфекционных
испытание: испытанием
история: истории
июль: июля
кавказ: кавказом
каждый: каждого
как: как
канализационный: канализационной
кандидат: кандидат
кафедра: кафедра, кафедры
качалкина: качалкина
километр: километров
ключевой: ключевые
книжный: книжной
когда: когда
койка: коек
количество: количество
который: которых
край: крае
красноармеец: красноармейцев
красный: красной
кровопролитный: кровопролитных
крупный: крупнейшую, крупные
курмангазиев: курмангазиева
левый: левый
ленинград: ленинграда
лечение: лечения
литература: литературы
лл: лл
лёт: лету
маршал: маршала
масса: масса
массовый: массового
медгиз: медгиз
медик: медики, медиков
медицина: медицина, медицины
медицинский: медицинские, медицинский, медицинских, медицинского, медицинской
медсанбат: медсанбата, медсанбатов
мерин: меринов
мероприятие: мероприятий
местный: местные
месяц: месяцы
метр: метров
можно: можно
молодёжный: молодёжной
мужество: мужество
мы: нами
навсегда: навсегда
наличие: наличие
налёт: налета, налеты
направить: направлено
наркомздрав: наркомздрав
население: населения
наука: наук
научный: научный
находиться: находившихся, находилась, находились, находился
начало: началу
начальник: начальника
начать: начали
невозможный: невозможной
недопущение: недопущение
немец: немцам
необходимость: необходимость
необходимый: необходимые
неоценимый: неоценимое
непосредственный: непосредственной, непосредственном
несколько: несколько
неспециализированный: неспециализированном
нехватка: нехватке
нко: нко
ночью: ночью
ноябрь: ноябре
областной: областного, областной
область: областей, области, область
облисполком: облисполкома
оборона: обороны
оборонительный: оборонительных
обслуживание: обслуживания
обстановка: обстановка
обстрел: обстрелами, обстрелов
обуславливать: обуславливало
общественный: общественных
обязанность: обязанности
огонь: огнем
огромный: огромной
один: одни, одно
однако: однако
ожесточённый: ожесточеннее
оказание: оказания
оказать: оказал
оказываться: оказывались
около: около
октябрь: октября
олегович: олегович
она: она
они: им, их, ним
оп: оп
опасность: опасность
операционный: операционная
орган: органы
организация: организации, организация
оренбург: оренбург
оренбургский: оренбургский
основный: основная
особо: особо
оставаться: остающийся
остаться: останутся
от: от
отдел: отдела
отделение: отделение
отделять: отделяли
отечественный: отечественной
отечество: отечества
откуда: откуда
отряд: отрядов
отсутствие: отсутствие
отчаянный: отчаянных
отчётный: отчетный
офсет: офсет
память: памяти
партийный: партийной
пассажирский: пассажирских
первостепенный: первостепенные
первый: первой, первые, первый, первых
перевести: переведены
перевозка: перевозках
перегрузка: перегрузкой
передний: переднем
переломный: переломных
переправить: переправлено
период: период
персонал: персонала
петербургский: петербургские
план: план, планов
плечо: плечом, плечу
победа: победы
погода: погоды
под: под
подвиг: подвиг
подлинный: подлинной
подходить: подходил
поезд: поездов
пожар: пожара
полевой: полевых
полиграфия: полиграфии
политика: политики
полковой: полковые
полностью: полностью
половина: половины
помещение: помещений
помочь: помогла
помощь: помощи, помощь
понимание: понимания
порой: порой
после: после
последовать: последовавшего
постоянный: постоянной
поступать: поступали, поступающих
поток: поток
потребовать: потребовали
потребоваться: потребовалось
право: правом
правый: правого
превратить: превращен
превратиться: превратилась
превышать: превышающей
преподаватель: преподаватель
при: при
принимать: принимал
припас: припасов
прифронтовой: прифронтовых
приходиться: приходилось
приём: приема
пробиться: пробиться
проблема: проблемой
продолжаться: продолжающиеся
промышленность: промышленность
промышленный: промышленные
прорыв: прорыв
пространство: пространства
противник: противника
противоэпидемический: противоэпидемических
профессионализм: профессионализм
проходить: проходила
проявить: проявили
прямо: прямо
пулемётный: пулеметным
пункт: пунктов, пункты
работа: работе, работу
работать: работали, работало
работник: работники, работников
рабочий: рабочих
развернуть: развернуто
развить: развитая
развёртывание: развертывание
развёртывать: развертывать
развёртываться: развертывались
размещать: размещать
размещаться: размещалось
разрушить: разрушены
район: районов
ранг: ранга
раненый: раненые, раненым, раненых
рассредоточение: рассредоточение
ребёнок: детьми
резко: резко
результат: результате
река: реки
ресторан: ресторане
ресурс: ресурс
решать: решали
роль: роль
рубеж: рубежей
ружейный: ружейно
руина: руинах, руины
руководитель: руководитель
руководство: руководством
рф: рф
сам: самом
самоотверженность: самоотверженность
самый: самый, самых
санитарный: санитарное, санитарных
санкт: санкт
саратов: саратов
свыше: свыше
связь: связи
сд: сд
северный: северным
сельский: сельское
сестра: сестер
сеть: сеть
сильный: сильных
символ: символом
система: системы
слово: слова, словами
совершенный: совершенного
советский: советских, советского
советско: советско
соединять: соединявшая
создавать: создавали
солдат: солдат, солдаты
сосредоточить: сосредоточено
состояние: состоянии
сотня: сотен
союз: союза
спасать: спасая
спасти: спасти
список: список
способствовать: способствовало
сражение: сражений
ссср: ссср
сталинград: сталинград, сталинграда, сталинграде, сталинграду
сталинградский: сталинградская, сталинградского, сталинградской
становиться: становилась
старший: старший
стать: стала
страна: страны
стратегический: стратегических
страшный: страшного
строительный: строительных
строительство: строительстве
студент: студент
судоходный: судоходные
суровый: суровым
сутки: сутки
существо: существу
тень: тени
территория: территории
тимошенко: тимошенко
типография: типография
тогда: тогда
только: только
торговля: торговли
транспорт: транспорте
требовать: требовало
труба: трубе
трудность: трудностью
тыл: тыла, тылу
тысяча: тысяч
тяжёлый: тяжелый, тяжёлых
увеличение: увеличения
удаваться: удавалось
уже: уже
украина: украиной
университет: университет
уничтожить: уничтожено
управление: управление, управления
усиление: усиление
условие: условия, условиями, условиях
устремиться: устремился
ухудшиться: ухудшилась
участиться: участились
участок: участке
училище: училищ
учреждение: учреждения
фашист: фашистов
фонд: фонда
фронт: фронт, фронта, фронтов
халат: халатах
хозяйственный: хозяйственные, хозяйственных
хозяйство: хозяйство
хороший: хорошая
хотеться: хотелось
цдниво: цдниво
цена: цены
центр: центром
часто: часто
чем: чем
число: числа, число
чуйков: чуйкова
штатный: штатные
штольня: штольне
эвакогоспиталь: эвакогоспиталей
эвакопункт: эвакопункта
эвакуационный: эвакуационная, эвакуационные
эвакуация: эвакуацию, эвакуация
эвакуировать: эвакуированного
эг: эг
экономика: экономике
экстремальный: экстремальные
электронный: электронный
это: это, этом
этот: эти, этому
эффективный: эффективной
эшелон: эшелонов
юго: юго
южный: южного, южном
