август: августа
автор: авторы
администрация: администрацией
акцент: акцентом
алексеевич: алексеевна
альт: альта
анастасия: анастасия
аннотация: аннотация
апальков: апальков
архивный: архивной
архитектурный: архитектурное, архитектурном
белолипецкий: белолипецкая
берег: берегу
благолепие: благолепие
больной: больному
борис: борис, бориса, борису
борисоглебск: борисоглебск, борисоглебска, борисоглебске
борисоглебский: борисоглебский, борисоглебской
борьба: борьба
бояр: боярами
брат: брата, братьев, братьях
братский: братской
бревно: бревен
былой: былое
быть: будет, был, была, были, было
важный: важным
варяг: варягов
век: вв, века, веке
великий: великого
вера: веры
весь: всей
взор: взоров
включая: включая
владимир: владимир, владимира
власть: власть
влияние: влияние
вместе: вместе
вместо: вместо
внимание: внимание
возникнуть: возникшем
ворваться: ворвались
ворона: вороны
воронеж: воронеж
воронежский: воронежский, воронежской
воспринять: воспринята
восходить: восходит
время: время
всероссийский: всероссийский
встреча: встречи
всё: все
вторгнуться: вторглись
входной: входная
выдолбить: выдолбленных
выждать: выждав
вызвать: вызвала
высокий: высоким
вышгород: вышгороде
где: где
глава: главе
главный: главным
глеб: глеб, глеба, глебу
глубокий: глубокие, глубокий
го: го
год: гг, года, годов, году
голованов: голованов
город: город, города, городе, городов
горожанин: горожан
горясер: горясером
государственный: государственный
государство: государства
град: граде
грех: грех
гроб: гробу
группа: группа
два: двух
день: день, дня
деревянный: деревянная, деревянном
детский: детские
деятель: деятелей
дизайн: дизайна
дискуссионный: дискуссионных
днепр: днепра
до: до
дождаться: дождаться
доныне: доныне
доц: доц
дочь: дочери
дощатый: дощатым
древний: древней
дружина: дружиной
духовно: духовно
духовность: духовности
духовный: духовное, духовные, духовным, духовных
евгениевич: евгеньевна
епархия: епархии
желать: желающие
живой: живого, живой
жизнь: жизни, жизнь, жизнью
жить: жить
забор: забором
завершить: завершить
закладка: закладки
заколоть: закололи
закрытый: закрыт
заложить: заложены
замотать: замотали
захватить: захватил, захватить
захоронить: захоронен
защита: защиту
здание: здание, здания
здесь: здесь
знаменитый: знаменитом
значение: значение
значительный: значительное
зона: зоны
зритель: зрителей
игровой: игровые
идея: идеи
из: из
известить: известил
известно: известно
икона: икона
именно: именно
именоваться: именовался
иметь: имеет
имя: именем
интерактивный: интерактивной
интернет: интернет
искусство: искусства
историко: историко
исторический: исторические
история: историей, истории
июль: июля
как: как
каменный: каменный
канонизировать: канонизированы
кафедра: кафедры
киев: киев
кирпич: кирпичом
кирпичный: кирпичного
ключевой: ключевые
книга: книг
князь: князей, князь, князьям, князя
колокольня: колокольня
комиссия: комиссии
конец: конце
кончина: кончина, кончиной
копьё: копьями
корень: корни
который: которые
край: край, краю
крепость: крепости, крепость
креститель: крестителя
кроме: кроме
кукольный: кукольными
культура: культура, культуре, культуры
культурный: культурного, культурное, культурным
купол: купол
лапина: лапина
летописный: летописным
лечь: ляжет
литература: литературы
любовь: любви
май: мая
материал: материалы
между: между
менее: менее
мероприятие: мероприятий, мероприятия
место: месте, местом
меч: мечом
микрофон: микрофон
мир: мире
митрополия: митрополии
молитва: молитвы
молодой: молодой
момент: моменту
монастырь: монастыри
московский: московского
мощь: мощи
муром: муромом
мученический: мученическая, мученической
название: название
назвать: названы
наслать: нашли
наследие: наследие, наследии, наследия
наталия: наталия
наука: науки
научный: научный
начало: началу
начать: начал, начато, начаты
начаться: началась
некий: некого
неразрывно: неразрывно
никакой: никаких
новопавловск: новопавловском
новый: ново, нового, новый, новым
нравственный: нравственных
нужный: нужное
о: об
обезобразить: обезображенное
обнаружить: обнаружил
образ: образ
общество: общества, обществе
один: одним, одно
оказать: оказал, оказали
окаянный: окаянный
окно: окна
он: его, ему, нему, он
она: нее, она
они: их, они
освещать: освещает
осквернить: осквернен
основать: основанный
оставить: оставили
остров: острове
от: от
отец: отец, отца, отцу
отечество: отечеству
открытие: открытие
открытый: открытой
относиться: относятся
отправить: отправил
отправиться: отправился
отразить: отражены
павловский: павловская, павловской, павловском
паломничество: паломничества
памятник: памятник, памятника, памятнике, памятники
память: памяти, память
патриархат: патриархата
пение: пение
первый: первая, первые, первым, первых
перед: перед
передавать: передают
перенести: перенесены
печенег: печенеги, печенегов
писатель: писателями
письменный: письменного
площадка: площадки, площадок
площадь: площадь
погибнуть: погиб
подвиг: подвигу
поддержка: поддержки
познакомить: познакомить
пока: пока
поколение: поколение, поколения
полотно: полотно
полоцкий: полоцкого
получить: получил
пообещать: пообещав
посвятить: посвященные
послать: посланные
после: после
последующий: последующие
построить: построена, построенной, построенный
похоронить: похоронили
почитание: почитание, почитанием, почитании, почитания
почитать: почитаемых
поэт: поэтами, поэтов
поэтому: поэтому
правило: правил
православный: православная, православной
празднование: празднованием, празднования
превратить: превращено
преддверие: преддверием
предложить: предложил
презентация: презентации
престол: престол
прибыть: прибыв
приказать: приказал
прихожанин: прихожан
проводиться: проводится, проводятся
прозаик: прозаиков
произведение: произведениях
пройти: прошло
просветительский: просветительские
простоять: простоявшая
псалом: псалмов
путша: путшу
пётр: петра
работа: работа, работы
развернуть: развернули
разграбить: разграблена
расположить: расположенная, расположено
распространиться: распространилось
рассказывать: рассказывает
рассказываться: рассказывается
рассматриваться: рассматриваются
регулярно: регулярно
резонанс: резонанс
река: рек, реки
религиозный: религиозен
реставрационный: реставрационные
ресурс: ресурс
решить: решили
рисунок: рисунок
рогволод: рогволода
рогнеда: рогнеды
родный: родному
рождение: рождения
россия: россии
ростов: ростовом
руководитель: руководитель
русский: русские, русских, русского, русской
русь: руси
рф: рф
ряд: ряды
с: со
сам: самого
свидетельство: свидетельствам
свободный: свободный
свой: своему, своим, своих, своё
связанный: связанного, связанные
связать: связаны
святой: святые, святым, святых
святополк: святополк, святополком
святославич: святославича
сгореть: сгорела
сентябрь: сентября
сердце: сердце
символ: символов, символом
склад: склад
скончаться: скончался
слава: славу
след: след
слияние: слиянии, слияния
словесность: словесности
словесный: словесного
слово: слова
слуга: слугой
смерть: смерти, смерть
смирение: смирения
смочь: смогли
снести: снесены
событие: события, событиями
совпасть: совпал
современный: современное, современном
согласие: согласии
согласно: согласно
создание: создание
сокрытый: сокрыто
соломенный: соломенном
сопровождать: сопровождавшие
сопротивление: сопротивления
сосредоточить: сосредоточено
состоять: состоявшим
состояться: состоялось, состоялся
сохранение: сохранение
сохраниться: сохранившегося
сохранять: сохраняют
спать: спать
список: список
средство: средства
старособорный: старособорная
старший: старший
старый: старейшим
стать: стал, стали, стало
статья: статье, статья
столица: столицу
стоять: стояла
страстотерпец: страстотерпцам
стремиться: стремясь
строительство: строительство
стройматериал: стройматериалов
студент: студент
сцена: сцена
сын: сын, сыновьями
такой: таких
творчество: творчества, творчеством
театр: театрами
тело: тело
тем: тем
территория: территорию, территория
технический: технический
только: только
тот: того
традиционный: традиционные
традиция: традиции
тяжкий: тяжкий
убийство: убийство
убийца: убийцы
убить: убит, убить
увезти: увезли
увеличить: увеличить
удел: удел
уже: уже
узнать: узнав
указ: указу
университет: университет
уничтожить: уничтожено
услышать: услышав
утварь: утварь
фестиваль: фестиваль, фестиваля
филиал: филиал
формирование: формирование
хопра: хопра, хопре
храм: храм, храма, храме, храмом, храмы
цель: цель
ценность: ценностей
центр: центром
центральный: центральными
церковный: церковная
церковь: церкви, церковь, церковью
часовня: часовня
чей: чьих, чья
человек: люди
чем: чем
честь: честь
читатель: читателей
что: что
шатёр: шатер, шатра
шатёрный: шатерное
широкий: широкий
это: этом
этот: этих, этот
являться: являются
ярмарочный: ярмарочные
