абазин: абазинами, абазины
август: августа
автор: авторов
агеев: агеева
адиль: адиль
адыг: адыгами
адыгский: адыгское
азербайджанский: азербайджанского
азов: азов
азовский: азовский
азовый: азово
ак: ак
активно: активно
александр: александр
александрович: александровна
али: али
алибиевич: алибиевич
алиев: алиевой
аннотация: аннотация
анчабадзе: анчабадзе
армия: армии, армия
арсланбек: арсланбек
астраханский: астраханский
атаковать: атаковали
баку: баку
без: без
беззаконие: беззаконие
белые: белые
берег: берегам
беспощадно: беспощадно
битва: битва, битве
близость: близости
бой: бои, бой, боями
более: более
болезнь: болезни
больший: большей, больших
большой: больше
борьба: борьба
брат: братьями
брать: берут
буг: бугом
буджакский: буджакская
бутырец: бутырцам
бутырский: бутырского
бывший: бывших
былой: былую
быть: будет, был, была, были, было, быть
важный: важная, важную, важный
ведь: ведь
век: вв, века, веке
вернуться: вернулся
верста: вёрст
верховье: верховья, верховьях
весь: весь, всему, всю
взаимоотношение: взаимоотношений, взаимоотношения
взять: взять
включая: включая
владимирский: владимирского
внезапно: внезапно
внимание: внимание, внимания
военный: военное, военную
воин: воинов, воины
воинский: воинские
воинственный: воинственного
война: войне, войны
войско: войска, войскам, войско
волков: волкова
вопрос: вопросу
восемь: восемь
восстание: восстание, восстанию, восстания
восстать: восставшие
восточный: восточного, восточный, восточных
впервые: впервые
время: времен, время
всеобщий: всеобщая
встретиться: встретились
всячески: всячески
всё: все, всё
второй: второй
входить: входили
вхождение: вхождение
вы: вам, вы
выводить: выводит
выдать: выдать
выйти: вышел
гарнизон: гарнизоны
где: где
генерал: генерал
геноцид: геноцид
геополитический: геополитические
гирей: гирей
глубокий: глубоким, глубоких
говорить: говорили, говорит, говорят
год: года, году, лет
голод: голод
горло: горлом
город: город
городок: городок
государственный: государственного, государственное
государство: государства
грек: греками
грозный: грозная
губернатор: губернатор
дагестан: дагестана
далёкий: подальше
даниял: даниял
дать: дали
действовать: действуя
декабрь: декабря
день: дни
десятка: десятки
деятель: деятели
диссертация: диссертации
длиться: длились
днепр: днепром
до: до
добить: добейте
добыча: добычу
договор: договор, договору, договоры
дойти: дошли
доктор: доктора
дон: дона, дону
достаться: достались
достигнутый: достигнутые
достойно: достойно
достойный: достойна
другой: другим
дуа: дуа
дунай: дуная
еда: еды
едисана: едисан
едисанский: едисанская, едисанских
едичкульский: едичкульская
едишкулец: едишкульцев, едишкульцы
еи: еи
ейский: ейский
екатерина: екатерины
емболука: емболуки
емболуковый: емболуков
емболукский: емболукская, емболукских
ещё: ещё
жалеть: жалели
жанеевец: жанеевцев
ждать: ждут
женщина: женщин, женщины
живой: живой, живых
жидков: жидкова
житель: жителей
жить: жили, жило
забыть: забыть
заведовать: заведующей
завершиться: завершился
завоевание: завоевания
завоевать: завоевать
завязаться: завязался
закончиться: закончилось
закубань: закубанью
зан: зан
занимать: занимали
западноевропейский: западноевропейских
запись: записей
заселить: заселена
засыпать: засыпаны
затрагивать: затрагивает
защищать: защищали
зверство: зверство
здесь: здесь
земля: земель, земли
знак: знак
знать: знать, знатью
значение: значение
зона: зоной
играть: играет
идти: шел
из: из
известие: известиях
издать: издана
изучать: изучая
илгас: илгасы
иль: иль
именно: именно
иметь: имели
императорский: императорской
императрица: императрицы
империя: империи, империя, империями
имперский: имперские, имперским, имперское
имя: имена
информация: информации
ирина: ирина
иртыш: иртыша
исконный: исконные
исмаил: исмаил
исследование: исследование
исторический: исторические, исторических, исторической, историческом
история: историей, истории, историю, история
источник: источниках
итог: итогом
июль: июле, июля
йылгас: йылгасы
кабак: кабаки
кавказ: кавказ, кавказа
кавказский: кавказского
казак: казаками, казаков
казачий: казачье
как: как
какой: какого
калмыков: калмыков
канакать: канакай
кантемир: кантемир
капитуляция: капитуляции
кара: кара
карагулов: карагулов
карательный: карательными, карательных
карта: карты
картина: картину
касаевский: касаевский
касай: касай
каспулат: каспулат
каспулатовский: каспулатовский
касым: касым
кафедра: кафедры
кекуатов: кекуатова
келембета: келембет
керейт: керейтов
керменчик: керменчик
кидирнияз: кидирниязов
кинбурна: кинбурн
кинуться: кинулись
кладбище: кладбищах
класс: класса
ключевой: ключевые
книга: книга, книги
князь: князь
кобанш: кобаншы
когда: когда
колонизация: колонизация
колонизировать: колонизировать
команда: команды
командир: командиры
командование: командованием
комендант: комендант
конный: конные
конфликт: конфликт
коренной: коренной, коренных
корень: корни
корпус: корпус, корпуса, корпусов
косить: косили
который: которая, которые, который
кочевать: кочевал
кочевье: кочевья
краевед: краеведа
край: края
крайне: крайне
краснодарский: краснодарского
крепость: крепостей, крепости, крепость
круг: круга, кругу
крым: крым, крыма, крыму
крымский: крымского, крымское
кубанец: кубанцев, кубанцы
кубанский: кубанская, кубанские, кубанского, кубанской
кубань: кубани, кубань
куговать: кугуй
культурный: культурные, культурных
кума: куме
курам: курама
лаба: лаба, лабы
лежать: лежали
леонтьев: леонтьев
лешкевич: лешкевич
листать: листая
литература: литературы
лишь: лишь
лоовский: лоовские
лука: луки
майоров: майоров
мало: мало
мамбета: мамбет
манычский: манычской
мбоу: мбоу
между: между
месяц: месяцев
мечеть: мечетях
мигрировать: мигрировали
миллион: миллион, миллиона
мир: мира, мире, миру
мирный: мирному
много: много
многолюдный: многолюдные
моздокский: моздокской
молитва: молитвы
монография: монографий
море: морем
мороз: морозы
москва: москва
мощь: мощь
мурза: мурз, мурза, мурзу, мурзы
мурзабеков: мурзабекова
мусавес: мусавес
мусалить: мусаль
мы: мы, нами, нас
надо: надо
называть: называют
намаз: намаз
намечаться: намечалось
нанести: нанести
нападать: нападает
напасть: напасть
народ: народ, народа, народами, народов, народы
народность: народностям
население: населения
настигнуть: настигли
насчитывать: насчитывает
наука: наук
наурузовский: наурузовский
научный: научный
находиться: находились
начало: начала, начале
начать: начал
начаться: начались, началось, начался
начинаться: начинается
наш: наша, наши, нашими, наших
невинный: невинных
недостать: недостать
независимый: независимая
незаметно: незаметно
нейтральный: нейтральной
некогда: некогда
некоторый: некоторые
немногочисленный: немногочисленным
немой: нем
неожиданно: неожиданно
несколько: нескольких, несколько
несмотря: несмотря
нет: нет
ни: ни
никто: никого
новороссийский: новороссийский
новрузовский: новрузовским
новый: новыми
ногаев: ногаев
ногаец: ногайцам, ногайцев, ногайцы
ногай: ногаи
ногайский: ногайские, ногайским, ногайских, ногайского, ногайской, ногайскую
ночь: ночь
нурадин: нурадин
нынешний: нынешнего
о: об
оба: обеим
обескровить: обескровлена
обозрение: обозрение
образование: образование
обратить: обратил
общество: обществу
обществознание: обществознания
огонь: огонь
один: одними
однако: однако
ожесточённый: ожесточённый
октябрь: октября
он: он
она: ее, она
они: им, их, они
орак: орак
орда: орд, орда, орде, орды
оружие: оружии, оружия
османо: османо
османский: османская, османской
основный: основное
особенно: особенно
остальной: остальных
остаток: остатки
остаться: оставшаяся, оставшимся, осталась, остались, осталось
от: от
отбивать: отбивает
отброс: отброс
ответить: ответили
отвлекать: отвлекавшего
отдохнуть: отдохнуть
отказываться: отказывавшихся
открытый: открытой
отменять: отменял
отодвинуть: отодвинули
оторопеть: оторопели
отрывок: отрывок
отряд: отряд, отряда, отрядов, отрядом, отряды
отступать: отступая
оттеснить: оттеснены
оттуда: оттуда
офицер: офицера
очередной: очередной
пасть: павших
педагогический: педагогического
первый: первой, первых
перевал: перевалы
перевес: перевес
перед: перед
передать: переданы
перейти: перейдем
переправиться: переправившись, переправились
перерезать: перерезанным
переселение: переселения
переселить: переселить
переселиться: переселились, переселиться
переслать: перешли
период: период
пир: пир
пламя: пламя
план: планы
планироваться: планировалось
племя: племени, племя
плен: плен
повстанец: повстанцам
погибнуть: погиб, погибли, погибло
поголовно: поголовно
под: под
поделиться: поделиться
подкрепление: подкреплений
подкумок: подкумке
подойти: подошли
подсчёт: подсчетах
пойти: пошел, пошёл
показать: показали
покрыться: покрылась
политический: политических, политического
половина: половине, половины
полок: полков
поминать: поминают
помощь: помощь
понимание: понимания
пономаренко: пономаренко
попытка: попытка
поражение: поражением, поражения
поразить: поражен
поручик: поручик, поручика, поручику
посвятить: посвятил
посередине: посередине
после: после
последний: последней, последние, последних
последствие: последствии, последствия
пост: пост
постичь: постигла
пострадать: пострадали
потерпеть: потерпели
потеря: потерь
потерять: потеряла
потомок: потомки
потушить: потушить
потёмкин: потемкин, потемкина
поход: походами
похолодать: похолодало
почему: почему
почти: почти
появиться: появился
пояс: пояс
правительственный: правительственным
правобережье: правобережья
предательство: предательством
предок: предков
предписать: предписал
предпоследний: предпоследнее
предыдущий: предыдущие
предыстория: предыстории
прекратить: прекратили
премьер: премьер
преподавание: преподавания
преследовать: преследовала, преследовать
при: при
приближение: приближении
привести: привела
признавать: признавала
признать: признала
прийтись: пришлось
прикрытие: прикрытием
принимать: принимали
принять: принял
припас: припасов
приток: притоках
приход: приходом
причина: причина, причинам
проблема: проблемы
проверять: проверять
провести: провести
проводить: проводили
проживать: проживавшим
произведение: произведение
прорваться: прорвалась
проснуться: проснулись
пространство: пространство
против: против
процесс: процессе
прочий: прочими
прочить: прочим
пушка: пушек
пытаться: пыталась
пятигорье: пятигорья
пять: пять
работа: работах
равнина: равнину
ради: ради
радиус: радиусе
разбить: разбил
развернуться: развернувшееся
развитие: развития
разграбить: разграблен
разгром: разгром
раздетый: раздетые
разорить: разорен, разорены
район: район, районе
раненый: раненым, ранеными
ранний: ранние
располагаться: располагалась
рассвет: рассвете
рассеять: рассеяны
рассеяться: рассеялся
рассказать: рассказаны
растерять: растеряла
рауциуса: рауциуса
ребёнок: детей, дети
редут: редутов
резко: резко
рейд: рейды
река: реке, реки, реку
речка: речки
решить: решил, решили
род: роду
родный: родной, родные
родоплеменной: родоплеменного
родственный: родственных
роль: роль
российский: российская, российские, российский, российской
россия: россией, россии
ружьё: ружей
руководитель: руководитель
русский: русская, русские, русскими, русских, русской
рф: рф
ряд: ряда, рядов
с: со
сабля: сабли
сайдахмедович: сайдахмедович
сали: сали
сам: самого, самом
самый: самая, самое
сара: сары
свой: свое, свои, своим, своих
связь: связи
себя: себя
северный: северного
северо: северо
северокавказский: северокавказском
севиндж: севиндж
середина: середине
серия: серию
сибирь: сибирь
сила: силами, силе, силы
сильно: сильно
сильный: сильный
скорбеть: скорбим
слияние: слияния
словарь: словарь
слово: слова
смотреть: смотрела, смотря
снег: снегом
событие: событий, события
совершать: совершали, совершать
современный: современного
соженна: соженны
солдат: солдат
соловьёв: соловьёва
солтан: солтан, солтана
сопредельный: сопредельными
соседний: соседними
состав: состав, состава
составлять: составляли
состояться: состоялось
социально: социально
сош: сош
список: список
справедливость: справедливости
справочник: справочник
спрашивать: спрашивать
спуститься: спустились
сработать: сработали
сражение: сражение, сражении, сражениях
ссылаться: ссылаясь
становиться: становился
старик: стариков
старцев: старцев
стать: стал, стали
степной: степной, степные
степь: степи, степь
стоить: стоит
сторона: сторону
стоять: стояли
страна: странами
стремиться: стремилась
су: су
суворов: суворов, суворова, суворову
судьба: судьба, судьбы
существование: существование
считать: считаем
табун: табунам
тав: тав
таки: таки
такой: такие, такую
талант: таланты
там: там
тамань: тамани
тапант: тапанта
телега: телег, телегах, телеги
темир: темир
тень: тени
теперь: теперь
территориальный: территориальные
территория: территории
технология: технологии
тогда: тогда
тоже: тоже
только: только
тот: те, тех, того
трагедия: трагедия
трагический: трагические
три: три
труп: трупов
тукас: тукас
туман: туман
турция: турции, турцию
тысяча: тысяч, тысячи
тысячный: тысячный
тюрк: тюрки
тюркский: тюркский
тяжело: тяжело
тяжёлый: тяжелая
убито: убито
убить: убили
увековечить: увековеченной
увидеть: увидел, увиденного
угнетать: угнетать
удалить: удалена
удар: удар
ударить: ударил
удаться: удалось
уделяться: уделяется
удивить: удивило
уже: уже
уздень: узденям
узнать: узнав
уйти: ушла, ушло
украинец: украинцами
укреплиния: укреплинии
университет: университета
уничтожить: уничтожено
упомянуть: упомянуть
урай: урай
ураковский: ураковские, ураковский
урал: урал
уренгой: уренгой
урочище: урочище
уруп: урупа
устроить: устроить
устройство: устройства
устье: устья
утром: утром
уходить: уходили
участвовать: участвовал
участие: участие
ученик: ученик
учитель: учитель
флаг: флаги
формирование: формирования
фрагмент: фрагмент
ханство: ханства, ханство
хитрость: хитрость
ход: ходе
хороший: лучшем
хотеть: хотел
храбрость: храбростью
целое: целом
цена: ценой
часть: части, часть
человек: людей, люди, человек
через: через
черкесов: черкесов
число: числа, числах
читать: читают
что: что
шагар: шагар
шагир: шагир
шамиль: шамиль
шар: шары
шегерский: шегерское
школа: школе
шор: шора
штурм: штурм
экономический: экономические, экономических, экономического
экспедиция: экспедицию, экспедициях
эл: эл
эли: эли
эпизод: эпизодов
эскадрон: эскадроны
этнический: этническая
этногенез: этногенеза
этнографический: этнографическое
это: это, этого
этот: эти, этих, этой, этот
юг: юг
южный: южным
юсуп: юсуп
я: меня
ялбулган: ялбулганов
яман: яман
