абилев: абилева
автор: автор, автора, авторов, автором, авторы
ази: азии
азия: азия
академи: академии
алламурат: алламуратов
алламуратов: алламуратова
алмат: алматы
анализ: анализ, анализа
аннотация: аннотация
археолог: археологов
археологиче: археологических
археологически: археологические
архитектурн: архитектурных
астан: астана
баз: база
базар: базари
балк: балки
балок: балок
баноч: баночного
барлас: барласы
бассейн: бассейна
бекствах: бекствах
берншт: бернштам
бернштам: бернштама, бернштамом
бит: битой
блюд: блюдо
боков: бокового
больш: больших, большое, большой
большинств: большинства
бревн: бревна
брусь: брусьев
булыжник: булыжника
бурх: бурх, бурха
бухар: бухаре, бухары
был: был, была, были, было
быт: быт
бытов: бытовой
бюллетен: бюллетень
вазочек: вазочек
варк: варки
вв: вв
век: веке
великолепн: великолепным
величин: величины
верн: верны
вертикальн: вертикальными
верх: верх
верхни: верхние
весьм: весьма
взаимодействи: взаимодействии
вид: вид, виде, видов
видимост: видимости
виднеется: виднеется
владевш: владевших
внутр: внутри
возводил: возводили
возвышени: возвышение, возвышении
возникновени: возникновение
вообщ: вообще
вопрос: вопрос
восточн: восточной
востребованн: востребованных
вплотну: вплотную
времен: времен, времени
все: все
встречаются: встречаются
втор: вторая
входит: входит
выделк: выделке
выпукл: выпуклым
выпускаем: выпускаемой
вырабатываются: вырабатываются
выработанны: выработанные
высок: высока, высоко, высокой
высоки: высокие
высококачественну: высококачественную
высочайш: высочайшей
высушенн: высушенная
высушивают: высушивают
выходит: выходит
выш: выше
гадл: гадло
гардан: гардани
где: где
генштаб: генштаба
главн: главным
гладк: гладкой
глазурованн: глазурованная, глазурованной
глин: глина, глиной, глину, глины
глинобитн: глинобитное, глинобитном, глинобитным
глинобитны: глинобитные
глинян: глиняной, глиняных
глиняну: глиняную
говоря: говоря
гончар: гончар, гончарного, гончаров
гончарн: гончарное, гончарном, гончарных
гончарств: гончарства
гор: горного
горизонтальны: горизонтальные
горн: горном, горный, горных
горшк: горшки, горшков
градостроительств: градостроительство
гребенк: гребенки
груб: грубой
групп: группы
дан: дан
данн: данное
дастархан: дастарханы
декун: декуна, декуне
дел: дела, дело
делалас: делалась
делающи: делающие
дерев: дерева
деревянн: деревянных
деятельност: деятельностей
дне: дней
дном: дном
до: до
долин: долине
дом: домом
домашню: домашнюю
дониш: дониш
дошедше: дошедшее
древ: древней
древн: древних
древнейш: древнейших
древни: древний
друг: других
други: другие
душанб: душанбе
европей: европейских
его: его
ее: ее
женщин: женщины
жерд: жерди, жердями
жизн: жизни
жилищ: жилища, жилище
журнал: журнале
завоевания: завоевания
закавказья: закавказья
законченность: законченностью
замк: замки
занимает: занимает
занималас: занималась
занимаются: занимаются
зат: затем
звук: звук
здес: здесь
земл: землю
земля: земля
зеравшан: зеравшана
зим: зимой
зимни: зимние
зимовках: зимовках
значительн: значительно, значительное
ибадулла: ибадуллаев
ибадуллаев: ибадуллаевым
из: из
изготовления: изготовления
изд: изд
издавн: издавна
издалек: издалека
издан: изданы
издают: издают
издели: изделии, изделий
изначальн: изначально
изразц: изразцы
изучен: изучена, изучено, изучены
изучени: изучение, изучением, изучению
изучения: изучения
изученн: изученным
изучив: изучив
изучивш: изучившего
изяществ: изяществом
имел: имела
имеют: имеют
имеюще: имеющее
импери: империи
инач: иначе
ино: иной
информация: информация
искусн: искусной
искусств: искусства, искусство
искусствоведче: искусствоведческий
исмаил: исмаила
использован: использована, использованы
исследовавш: исследовавшего
исследовани: исследование, исследовании, исследованию
исследования: исследования
исследовател: исследователей
исследуем: исследуемая
истори: истории, историю
историк: историко, историков
историография: историография
историче: историческая
история: история
источник: источника
источниковедче: источниковедческая
их: их
кажд: каждый
казахстан: казахстан, казахстана
как: как, какого
кам: камней
каркас: каркас, каркаса
карлук: карлуки
кас: каса
катакомбах: катакомбах
катыш: катышей
качеств: качества, качество, качеством
квартал: кварталы
керамик: керамика, керамики, керамику
керамиче: керамических, керамическое
керамическ: керамического, керамическом
керамически: керамические
кирпич: кирпича
кисляк: кисляков
кисляков: кислякова
клал: клали
классификаци: классификации
ключевы: ключевые
ко: ко
козел: козел
коллективизаци: коллективизации
композициям: композициям
конструкци: конструкции
конц: конце, концу
котл: котлов
котор: которая, которого, которой, которым, которых
которы: которые
кочевник: кочевников
край: крайней
красн: красным
красот: красоты
края: края
критери: критерии
круг: круга, кругу
кругл: круглое
крупны: крупные
крынок: крынок
крыш: крыши
кувшин: кувшины
культ: культ
культур: культура, культуры
кум: кума
кухонн: кухонной
кыргыз: кыргыз
кыргызск: кыргызского
кыргызстан: кыргызстана
лент: лент
ленточн: ленточной
лепил: лепили
лепк: лепки
лепн: лепная
лечебны: лечебные
литератур: литературой, литературы
лиш: лишь
лучш: лучше
мавераннахр: мавераннахре
мавзол: мавзолей
мал: мало
мастер: мастера
мастерским: мастерскими
материал: материал, материалам, материалами, материалов, материалом, материалы
межд: между
меньш: меньше
мер: мере
мест: местного, место
местн: местным
местност: местности, местность
металличе: металлический
метод: методы
методическ: методической
мнени: мнению
мног: многих
можн: можно
монгольск: монгольского
моск: моск
москв: москва
музе: музеев
музея: музея
мус: муса
мусаиповн: мусаиповна
над: надо
наз: назым
названи: название
наиболе: наиболее
найденн: найденных
наклонн: наклонными
нам: намного
направлени: направлении
направлениям: направлениям
например: например
народ: народа, народов
наряд: наряду
населения: населения
настилался: настилался
насыпалас: насыпалась
наук: наук, науки
научн: научно, научной
находк: находки
находках: находках
находок: находок
националь: национального
национальн: национальное
начал: начале, начало
наш: наших
невысоки: невысокий
неглазированн: неглазированных
некотор: некоторых
некоторы: некоторые
необходим: необходимо
неповторимы: неповторимые
неравномерн: неравномерный
нескольк: несколько
нескольким: нескольким
несмотря: несмотря
нечетн: нечетное
низ: низу
ним: ним
них: них
ничтожну: ничтожную
носит: носит
оазис: оазисе
об: об
обжиг: обжиг, обжига, обжиге
обжигательн: обжигательной
обильн: обильным, обильных
обладает: обладает
обмазк: обмазкой
обмазывался: обмазывался
образ: образом
образц: образцы
объективны: объективные
обыкновенн: обыкновенная
обыкновенну: обыкновенную
обычн: обычно
одним: одним
окол: около
округ: округу
окружающ: окружающей
он: он
описан: описана
описыв: описывая
описывает: описывает
опорн: опорными
опорны: опорные
определенн: определенном, определенных
опубликован: опубликовано
опубликованн: опубликованных
опубликованны: опубликованные
орех: ореха
орнамент: орнаментом
оседл: оседлого
основ: основе, основой, основу
основани: основании
основны: основные
особ: особо
особенн: особенно
особенност: особенности
остаются: остаются
от: от
отверсти: отверстие
отдельн: отдельных
отличаются: отличаются
отличи: отличие
отметит: отметить
относящихся: относящихся
отношени: отношений
отношения: отношения
оттиск: оттисков
офицер: офицерами
охарактеризован: охарактеризованы
очаг: очаг
памир: памиров
пахс: пахсы
первы: первые
перед: перед
переживше: пережившее
перекрытия: перекрытия
перемешанн: перемешанной
период: период
перспективн: перспективных
петербургск: петербургского
печ: печи
пиал: пиала
пишет: пишет
пищ: пищи
поверхност: поверхности, поверхность
поверьям: поверьям
повсеместн: повсеместно
погребаль: погребального
под: под
поддержания: поддержания
подтверждают: подтверждают
подход: подход, подхода
подходил: подходила
подчеркнут: подчеркнуть
подытожит: подытожить
позици: позиции
показал: показало
покрывалас: покрывалась
покрывалис: покрывались
пол: пол
полихромны: полихромные
половин: половина
получают: получают
поляк: поляков
поляков: полякова, поляковым
помещени: помещений
поперечн: поперечных
попол: пополам
попыталас: попыталась
поражал: поражало
посвящен: посвящена
поселени: поселении
поселения: поселения
поселениях: поселениях
поскольк: поскольку
посл: после
последовательност: последовательности
пособи: пособие
постройк: постройки
постукивания: постукивания
посуд: посуда, посудой, посуду, посуды
пот: потом, потому
потребност: потребность
поход: походом
почвенну: почвенную
появляются: появляются
практик: практики
прах: прах
превосход: превосходного
предварительн: предварительно
предмет: предметами
предполагает: предполагает
представлен: представлена
представляет: представляет
представляющи: представляющие
преимущественн: преимущественно
преобладают: преобладают
претендует: претендует
при: при
прибавлени: прибавление
приведен: приведены
привел: привели
привилег: привилегией
привлечени: привлечением
приготовлени: приготовлением
признак: признаков
прикладн: прикладное
применени: применение
пример: примере
примитивн: примитивная
принадлежност: принадлежность
проанализировал: проанализировали
проблем: проблеме
проблемн: проблемно
проведен: проведен
проводивш: проводивших
производств: производства, производстве, производство
промежутк: промежутки
промысл: промыслов
пропитания: пропитания
прост: простым
процветания: процветания
процесс: процессе
прочн: прочно
прочность: прочностью
публикаци: публикаций
путешественник: путешественников
путешествнник: путешествнниками
пят: пяти
пятн: пятном
работ: работа, работами, работе, работы
равнин: равнине
развивающейся: развивающейся
развит: развито
развити: развитие, развитии, развитию
развития: развития
развиты: развитые
раздроблен: раздроблена
различн: различной
размоченн: размоченная
разнообразн: разнообразный
районах: районах
ранн: ранной
раннесредневековы: раннесредневековые
раскопок: раскопок
расписну: расписную
располагалис: располагались
распространени: распространение
рассмотрен: рассмотрен
растительность: растительностью
расширяющееся: расширяющееся
расщепленны: расщепленные
редк: редко
рек: реки
ремесел: ремесел
ремесл: ремесла, ремесло
ремесленн: ремесленных
республик: республики
российск: российской
руководител: руководитель
рус: русских
ручн: ручной, ручным
сам: самым
саман: самана, самани
сапаллинск: сапаллинской
сапаллитеп: сапаллитепе
сведения: сведения
сверх: сверху
свидетельствует: свидетельствует
свидетельствуют: свидетельствуют
свидетельствующ: свидетельствующей
свидетельствующу: свидетельствующую
сво: своего, своей, свои, своих
свойств: свойства, свойствами
сдал: сдал
сделавш: сделавшей
сделанн: сделанная
себ: себе
сельски: сельские
сер: серых
символ: символам
систем: системного
системн: системным
скудн: скудной
славилис: славились
следовательн: следовательно
следующи: следующие
слепленн: слепленных
сло: слой
слов: слова
сложения: сложения
сложенн: сложенном
служб: службы
служил: служили
служит: служит
снабжавш: снабжавших
снаруж: снаружи
сначал: сначала
соб: собой
совершенств: совершенстве
совет: советская, советский
современник: современников
согд: согда, согде
согдий: согдийская
создал: создали
создающ: создающих
солнц: солнце
солом: соломой, соломы
сооружени: сооружений
сооружения: сооружения
составлял: составлял
сосуд: сосуда, сосудов, сосуды
сохранилас: сохранилась
спб: спб
список: список
спокойствия: спокойствия
способ: способом
сравнительн: сравнительно
сред: среди, средней
средневеков: средневековой
средняя: средняя
сср: сср
ссср: ссср
ставил: ставили
стал: стали
станков: станковая
становления: становления
старейш: старейшего
статус: статус
стать: статье
статья: статья
стен: стен, стены
стенк: стенки
стилистическ: стилистического
стоит: стоит
столб: столбами, столбы
столиц: столице
стран: стран, странам
строит: строить
строител: строители
строительн: строительным
строительств: строительстве
суф: суфа
существовавш: существовавших
существовал: существовали, существовало
существующим: существующими
сфер: сфер
сыр: сырым
сырцов: сырцового
та: та
таджик: таджики, таджиков
таджикистан: таджикистана, таджикистане
таджикск: таджикского
так: таких
таки: такие
таким: таким
тандыр: тандыры
тараз: таразе
ташкент: ташкент
ташкентск: ташкентском
тем: тема
температур: температуре, температурой
тень: тенью
тесн: тесном
техник: техника, технике
техническ: технически, техническом
технологиче: технологических
технология: технология
тип: типа
той: той
толст: толстой
толщин: толщину
тольк: только
том: том
тонки: тонкие
тополя: тополя
торгов: торгово, торговых
торговы: торговые
традиционн: традиционная, традиционном, традиционный
требует: требует
тростник: тростника
туземц: туземцев
турсун: турсунов
турсунов: турсунова
тюрк: тюрки
тян: тянь
убоги: убогие
углов: угловыми
углублени: углубление
удерживает: удерживает
уже: уже
узбекистан: узбекистана
узбекск: узбекской
указанн: указанная
уклад: уклад, укладе
укладывал: укладывали
укреплял: укрепляли
уложенны: уложенные
ун: ун
университет: университета
упоминает: упоминает
употреблени: употреблением
установит: установить
устойчивы: устойчивые
устоявшимся: устоявшимся
устраивается: устраивается
утвар: утварь
утверждает: утверждает
утверждают: утверждают
учебн: учебное
фан: фан
феврал: февраль
феодализм: феодализма
ферганск: ферганской
форм: форм, формам, формы
функциональн: функциональная
функциональну: функциональную
характер: характер
хив: хиве
хинго: хингоу
хисор: хисор
ход: ходе
хозяйств: хозяйстве
хорезм: хорезм
храм: храмы
хронологиче: хронологический
хронологическ: хронологического, хронологической
хуж: хуже
хум: хумов, хумы
цел: целом
целебн: целебными
целенаправленны: целенаправленные
центр: центра, центров, центры
цокол: цоколе
част: часто
частност: частности
черепк: черепка
черн: черная
черточек: черточек
честност: честности
числ: числе, число
что: что
шаг: шаги
шаня: шаня
шерабад: шерабаде, шерабадская, шерабадских
шест: шести
широк: широкое
широким: широким
шиш: шишов
шишкин: шишкина
шишов: шишова
школ: школа
шло: шло
щедрост: щедрости
эволюцион: эволюционного
этап: этапы
этих: этих
этнограф: этнографа, этнографов
этнографиче: этнографическое
этнографически: этнографические
этнографическим: этнографическими
этнография: этнография
это: это
этог: этого
этот: этот
юг: юг
южн: южного, южных
юлдош: юлдошев
является: является
являющееся: являющееся
яйцевидн: яйцевидной
якуб: якубов
якубов: якубова
ямок: ямок
январ: январь
