автор: автор
адаптация: адаптации
адаптировать: адаптированному
акт: актов
актуальный: актуальным
александров: александровой
алексей: алексей
англ: англ
аннотация: аннотация
ансамбль: ансамбль
аранжировать: аранжируем
аранжировка: аранжировки, аранжировку, аранжировок
архаичный: архаичные
атмосфера: атмосфера
аудитория: аудитории
аутентичность: аутентичности
аутентичный: аутентичного, аутентичной, аутентичных
баланс: баланса
без: без
бесценный: бесценное
битый: бит
благодаря: благодаря
более: более
большой: большой
бровь: брови
бросить: брошу
будущее: будущим
будущий: будущему
быстрый: быстрый
быть: была, были, быть
важно: важно
вариант: варианте
вдохновение: вдохновения
век: вв
версия: версия
весь: всей, всех
весьма: весьма
взаимодействие: взаимодействие, взаимодействию
взгляд: взгляд, взгляда
взять: взята, взяты
видеть: видит
википедия: википедия
включить: включены
владимирович: владимировна
влияние: влияниям
влиять: влияет
возможно: возможно
возможность: возможности
возникнуть: возникло
возрастать: возрастает
волнующий: волнующих
вопрос: вопрос, вопросу
восприятие: восприятию
вписываться: вписываются
впоследствии: впоследствии
время: времени, время
вскрыть: вскрыть
второй: вторая
высказывать: высказывает
вытеснять: вытесняет
выявить: выявленная
гармония: гармония
гетерофонном: гетерофонном
гибридный: гибридного
глинка: глинка, глинки
год: гг
голос: голоса, голосом
городской: городского
государственный: государственной, государственный
группа: групп
даже: даже
далее: далее
два: два, две, двух
делать: делает
денис: денис
державин: державина
диалект: диалекта
динамично: динамично
диск: диск
диско: диско
добавляться: добавляется, добавляются
доброта: доброта
добычин: добычин
документ: документе
должный: должна
дом: дом
достояние: достояние, достоянии
доступ: доступа
доступный: доступным
драматургия: драматургию
другой: другими, других
друцкай: друцкая
дума: думой
душа: душу
её: её
жанр: жанра, жанров, жанром
жизненный: жизненные
жизнь: жизни, жизнь
жокей: жокеями
забвение: забвению
заинтересованность: заинтересованности
заинька: заинька
заключаться: заключается
закон: закон
заложить: заложили
зап: зап
западный: западная
записать: записана, записанной
заслуживать: заслуживает
затрагиваться: затрагивается
звук: звуков
звуковой: звуковых
звучание: звучание, звучания
звучать: звучали
знаменский: знаменского
знать: знает
иван: иван
иванов: иванов
из: из
известный: известной
изд: изд
именно: именно
иметь: имеет, имеющая
индустрия: индустрии
институт: институт
инструмент: инструментов
интеграция: интеграции, интеграция
интегрироваться: интегрировалась
интенсивно: интенсивно
интервью: интервью
интересный: интересна, интересной, интересную
интернет: интернет
интерпретация: интерпретации
интонация: интонациями
информационный: информационный, информационных
искусство: искусство
искусствоведение: искусствоведения
исполнительница: исполнительницы
использование: использованием
использовать: используют
использоваться: используется
история: истории
исходить: исходя
исходный: исходного
исчезать: исчезающего
итог: итоге
йорк: йорке
как: как
какой: каким
кальницкий: кальницкая
канал: канал
канд: канд
кафедра: кафедры
классический: классическим, классического
ключевой: ключевые
когда: когда
колечко: колечко
коллектив: коллективами
композитор: композиторы
композиция: композиции, композиций, композиция
компонент: компонентами
комсомолец: комсомолец
конец: конца
контекст: контекст, контексте
концепция: концепция
концертный: концертных
кострома: кострома
который: которая, которое, которому, которые, который
край: края
красочный: красочная
культура: культура, культуру, культуры
культурный: культурное, культурной
купать: купала
лаконично: лаконично
лирический: лирическая
литература: литературы
личный: личного
локальный: локальной
любовь: любовь
манера: манеры
мария: мария
марфино: марфино
масса: массу
материал: материала
между: между
мезинец: мезинец
мелодия: мелодии
меняться: меняющейся
местный: местного, местный
место: месте
механизм: механизма
многий: многими
много: много
многообразие: многообразия
молодёжь: молодежи
москва: москва
мотив: мотивов, мотивы
мочь: можем
музыка: музыка, музыке, музыки, музыкой, музыку
музыкально: музыкально
музыкальный: музыкального, музыкальной, музыкальный, музыкальных
музыкант: музыкант, музыканты
мы: мы
название: название
найти: найти
накладываться: накладываются
напев: напевов
напеть: напев
написание: написания
направить: направлена
направление: направлении, направлений
народ: народ, народов
народный: народная, народно, народной, народные, народный, народных
нарушение: нарушения
наследие: наследия
настоящий: настоящее
научный: научный
находиться: находится
национальный: национальное
начало: начала, начале
наш: наше, нашей
нематериальный: нематериального, нематериальном
необычайно: необычайно
несомненно: несомненно
ни: ни
николай: николай
новомодный: новомодная
новый: нового, новое, новые, новый, новым
нью: нью
обеспечение: обеспечения
обеспечить: обеспечить
обладать: обладает
область: области
обозначить: обозначить
обрабатывать: обрабатывающие
образ: образ, образом
образец: образцов, образцом
обретать: обретает
обсуждаться: обсуждается
общаться: общаются
общность: общностей
объединить: объединившей, объединил
обычно: обычно
огурцовый: огурцовым
один: одной, одном
однако: однако
однозначно: однозначно
он: его, он
она: ее, ней, неё, она
они: им, их, они
опираться: опираются
определённый: определенные
опубликование: опубликование
организационный: организационных
оригинальный: оригинальной
основа: основ, основой, основу
основной: основной, основные
основный: основная
основываться: основывается
от: от
ответ: ответ
отдельный: отдельных
отметить: отмечу
отражать: отражает
официальный: официальное
очень: очень
певец: певец
певческий: певческой
педагогический: педагогический
пение: пения
первоисточник: первоисточника, первоисточников
первый: первый, первых
передавать: передающих
передаваться: передается
передать: передать
передача: передача
переосмысление: переосмысление
перкусие: перкусия
песенный: песенная, песенного, песенное, песенных
песня: песен, песни, песню, песня
петь: поют
плагин: плагины
площадка: площадках
плясовой: плясовая
повторить: повторить
под: под
подвергаться: подвергаться
подкладывать: подкладывает
подлинный: подлинная
позволить: позволит
поздний: позже
позиция: позиции, позицию
поколение: поколению, поколениям
покровый: покрово
получить: получившим, получило
получиться: получилась
помочь: помогут
поп: поп
популяризация: популяризации
популярный: популярными
поработать: поработать
послужить: послужил, послужила
пост: пост
постепенно: постепенно
потенциал: потенциал
потеря: потери
потерять: потеряла
потому: потому
появление: появлением
правовой: правовых
президент: президентом
преподаватель: преподаватель
при: при
привести: привел, привело
придерживаться: придерживаясь
пример: примера
примитивный: примитивным
принять: принятый
проблема: проблема
продюсер: продюсер
проект: проектов
произведение: произведения
производный: производным
происходить: происходила, происходит
просто: просто
простой: прост, проста, простые
простор: просторах
протяжение: протяжении
проходить: проходящих
процесс: процесс, процесса
путин: путиным
путём: путем
работать: работаем
развиваться: развивается, развивалась
развитие: развитие, развитием, развития
различный: различные, различных
размер: размер
разнообразный: разнообразных
разностилевой: разностилевая
разрушить: разрушен
район: района
ранний: ранней
раскрываться: раскрывается
раскрыть: раскрыть
распространение: распространении
рахманинов: рахманинова
режим: режим
результат: результате
ремикс: ремикс, ремикса
репрезентация: репрезентация
ресурс: ресурс
ритм: ритмы
родный: родное
романович: романович
романс: романса
российский: российской
рубеж: рубежом
руководитель: руководитель
румянцев: румянцев
русайнс: русайнс
русский: русская, русский
рф: рф
рэйв: рэйв
ряд: ряда
самобытность: самобытности
свободный: свободная
свой: своих, свою
связать: связана
сегодня: сегодня
сейчас: сейчас
секвенсор: секвенсоров
село: села, селе
сельский: сельский
семпл: семплов
сестра: сестер
синтезатор: синтезаторов
синтезировать: синтезированные
сказать: сказать
скрестить: скрестивших
следующий: следующей
слово: слова
сложность: сложностей
сложный: сложная
слушатель: слушателю
смысл: смысл, смысле
снетковый: снетковым
соблюдение: соблюдения
современность: современности
современный: современная, современного, современной, современном, современному, современные, современный, современным, современными, современных
согласно: согласно
содержание: содержание
содержательность: содержательности
содержательный: содержательной
соединение: соединения
создавать: создаваемого, создавая
создаваться: создается, создаются
создание: создание, созданию, создания
создать: созданный
состояние: состоянии
соул: соул
сохранение: сохранение, сохранении, сохранению, сохранения
сохранить: сохранить
сохранность: сохранность
сохраняться: сохраняется
социальный: социальной
сочинять: сочиняет
список: список
сплетение: сплетении
способ: способы
способствовать: способствует
среда: среды
стандартный: стандартный
стараться: старались
старое: старого
старостин: старостин
статистика: статистика
стать: стал, стали
стиль: стиле, стилей, стилем, стиль
стоить: стоит
страна: страны
стремиться: стремятся
структура: структура, структуры
студент: студент
существенный: существенной
существовать: существуют
такой: такие
тамбов: тамбов
тамбовский: тамбовский, тамбовского, тамбовской
танцевальный: танцевальными, танцевальных
творческий: творческого
творчество: творчества
телеведущий: телеведущий
тело: тело
тема: тема
темп: темп
технический: технических
технология: технологий
течение: течению
только: только
тот: те, том, тот
традиционный: традиционного, традиционные, традиционными, традиционных
традиция: традиции, традиций
транслирование: транслирование
трансляция: трансляции
трансформироваться: трансформируется
труд: труд, труда
трудность: трудностей
указывать: указывает
универсальный: универсальные
университет: университет
уникальность: уникальность
уникальный: уникальные
уровень: уровне, уровнем
ус: ус
условие: условии, условиям, условиях
успешно: успешно
утверждать: утверждает
учёный: ученый
фанк: фанк
федеральный: федеральный
федерация: федерации
фз: фз
физически: физически
финальный: финальная
фолкнуть: фолк
фольклор: фольклор, фольклора
фольклорный: фольклорная, фольклорной
фонограмма: фонограммы
форма: форму, формы
фундамент: фундамент
фёдоров: федоров
ха: ха
хай: хай
хотеться: хочется
художественный: художественной
ценность: ценности, ценность
ценный: ценной
цепочка: цепочек
цитата: цитаты
человек: людей, люди
человеческий: человеческие
человечество: человечества
чикаго: чикаго
что: чего, что
чувство: чувства
шадров: шадровых
широкий: широкой
эклектик: эклектики
эксперимент: экспериментов
экспериментальный: экспериментальной
электро: электро
электроника: электроникой
электронный: электронная, электронной, электронную, электронный, электронных
элемент: элементов, элементы
энерджи: энерджи
энциклопедия: энциклопедия
эра: эры
этап: этапе
этнический: этнических
этнограф: этнограф
этнокультурный: этнокультурного, этнокультурном, этнокультурных
этномузыкант: этномузыкантов
этномузыколог: этномузыкологами
этномузыкология: этномузыкология
это: это, этом
этот: эти, этой, этот, эту
эффект: эффектов, эффекты
являться: является
языковой: языкового
яркий: ярких
