абхазия: абхазией, абхазии
август: августа, августе
акт: актами
активный: активного, активным
акцент: акцент
акцентировать: акцентировали
акция: акциях
аланович: аланович
анализ: анализ
аннотация: аннотация
арена: арене
асад: асадов
баззаесть: баззаев
баранов: баранов
безопасность: безопасности
бизнес: бизнесом
ближний: ближнего
больший: наибольшую
большой: больше
брикс: брикс
быть: был, были, было
бюрократизироваться: бюрократизироваться
важность: важность
валентина: валентина
вестись: ведется
весь: всеми, всех, всю
взаимно: взаимно
взаимный: взаимной
взаимодействие: взаимодействии, взаимодействия
взамен: взамен
взгляд: взгляд
властный: властных
власть: власти
влияние: влияние
влиять: влиять, влияя
влксм: влксм
вместо: вместо
внешнеполитический: внешнеполитических
внимание: внимание
внутриэкономический: внутриэкономических
вовлечение: вовлечении
военный: военно, военной, военных
возможность: возможности, возможность
возраст: возрасте
война: войн
волонтёрский: волонтерской
вооружённый: вооруженного, вооруженными
вопрос: вопрос, вопросов
воспитание: воспитание, воспитания
время: времени, время
вследствие: вследствие
встать: встал
всё: все
вуз: вузами
вузовский: вузовского
вывод: выводы
выделяться: выделяются
выйти: вышел
выполнять: выполняла, выполнять
высокий: высшего, высшее, высший
выстраивать: выстраивают
гатикоев: гатикоева
где: где
говорить: говорить
год: года, годах, годов, году, годы, лет
город: городе
государственность: государственности
государственный: государственного, государственной, государственном, государственные, государственный
гражданин: граждан
гражданский: гражданских, гражданскую
грузино: грузино
грузинский: грузинского
гуманитарный: гуманитарного, гуманитарное, гуманитарной, гуманитарному
давать: давая, дает
данный: данный
дата: дата
дать: данные
два: двух
двусторонний: двусторонних
действие: действия
декларация: декларация
делать: делая
делаться: делается
дело: дел
демография: демографии
день: день
деятельность: деятельности, деятельностью
диплом: дипломы
дипломатический: дипломатических
днр: днр
до: до
добиваться: добивалась
договор: договор
документ: документ, документа, документе, документов, документы
долгосрочный: долгосрочные
должность: должности
донецкий: донецкой
дополнение: дополнениями
доступ: доступа
другой: другими
дружба: дружбе
духовный: духовного
евразия: евразия
ельцин: ельцина
жизнь: жизни, жизнь
журнал: журнал
задача: задачей, задачи
заключить: заключены
закон: закон, законом, закону
законодатель: законодателей
закрепить: закрепивший
занимать: занимать
заниматься: занималось, заниматься
занятость: занятости
западный: западными
зарубежный: зарубежных
зарубежье: зарубежья
знать: знает
из: из
изменение: изменениями
изучать: изучать
изучение: изучение
именно: именно
инвестиция: инвестиций
инициатива: инициативу
институциональный: институциональные
интеграция: интеграция
интерес: интересах, интересы
испытывать: испытывала
исследование: исследований
история: истории, историю, история
кавказоведение: кавказоведения
кадровый: кадровой
как: как
катализатор: катализаторами
кафедра: кафедры
ключевой: ключевые, ключевыми
комитет: комитета
коммунистический: коммунистической
комплекс: комплекса
комплексный: комплексная
конец: конца
конкурс: конкурсах
консолидация: консолидацию
конституция: конституцией
консультация: консультаций
контекст: контексте
конференция: конференциях
конфликт: конфликта, конфликтами
концепция: концепции, концепция
корн: корне
который: которая, которое, котором
кпсс: кпсс
кризис: кризис
круглый: круглого, круглых
крупный: крупных
крушение: крушения
культура: культуре, культуру, культуры
культурный: культурного
лагерь: лагерях
литература: литературы
лнр: лнр
локус: локус
луганский: луганской
льготник: льготников
май: мая
мансур: мансуров
массово: массово
материал: материалов
медицинский: медицинскую
межвузовский: межвузовского
между: между
международный: международная, международного, международное, международной, международном, международных
менять: меняющее
меняться: меняется
мера: мер, мерах, мерой, меры
мероприятие: мероприятий, мероприятиях
место: месте
мид: мид
министерство: министерств, министерства, министерство
министр: министров
мировоззрение: мировоззрения
многое: многое
мобилизационный: мобилизационных
можно: можно
молодой: молодого, молодых
молодёжный: молодежная, молодежного, молодежной, молодежных
молодёжь: молодежи, молодежь
момент: момент
москва: москве, москвы
мочь: может
муниципальный: муниципальных
мы: мы
наметиться: наметились
направить: направленная
народный: народных
население: населения
наследие: наследию
настоящий: настоящее, настоящим
наука: науки
научно: научно
научный: научного, научными, научных
национальный: национального, национальной, национальные, национальных
начинать: начинает
наш: наша
независимость: независимости
необходимый: необходима, необходимых
непрерывно: непрерывно
непростой: непростые
несмотря: несмотря
николай: николай
ничего: ничего
новый: нового, новой, новые, новый, новым
нормативный: нормативно
ноябрь: ноябре
нынешний: нынешнюю
о: об
оба: обеих
обеспечение: обеспечения
обеспечиваться: обеспечивается
область: областей, области
облисполком: облисполком
обмен: обмена, обмену
образ: образом
образование: образование, образовании, образования
образовательный: образовательную, образовательных
образоваться: образовались
обращение: обращения
обстановка: обстановки, обстановку
обсудить: обсудили
обсуждение: обсуждением
обучение: обучение
общественно: общественно
общественный: общественного, общественных
общество: общество
общий: общие
объединение: объединений, объединения
однако: однако
оказаться: оказалось
он: его, него
они: им, они
оон: оон
описать: описанный
орган: органов
организационно: организационно
организация: организации, организаций, организациями
организовать: организованная
организовывать: организовывают
осетинский: осетинские, осетинский, осетинских, осетинского, осетинской, осетинском
осетиный: осетино
осетия: осетией, осетии, осетия
основа: основы
основать: основанных
особенность: особенности
от: от
отдельный: отдельных
открыться: открылся
отношение: отношение, отношений, отношению, отношения
отстаивание: отстаивания
официальный: официальный, официальных
партия: партии
партнёр: партнером
патриотизм: патриотизма
патриотический: патриотические, патриотических, патриотического
первоочередной: первоочередных
первый: первый
переговоры: переговоры
перестать: перестал
переходить: переходя
перечень: перечня
перспектива: перспективы
план: плане
плотный: плотных
поддержание: поддержание
подписать: подписан, подписаны
подход: подходы
позволять: позволяют
позиция: позицию
поколение: поколения
политика: политика, политике, политики, политикой, политику
политический: политические, политических, политической
полноправный: полноправным
положение: положение
положительно: положительно
получать: получать
получение: получением
помощь: помощи, помощь
понимание: понимании
популяризация: популяризацию
после: после
последний: последние
постепенно: постепенно
постсоветский: постсоветском
появиться: появилось
право: права
правовой: правовые, правовыми
практически: практически
практический: практический
предлагать: предлагает
предложить: предложить
предок: предков
предполагать: предполагает, предполагающие
предполагаться: предполагается
представитель: представители
представить: представленной
представлять: представляем
прежний: прежних
президент: президента
прекращение: прекращения
преобразование: преобразований
преподавание: преподавание, преподавания
преподаватель: преподаватель
привести: привело
привлечение: привлечение, привлечению
приграничный: приграничных
призвать: призванные
признание: признание, признания
признать: признаны
принимать: принимает
приниматься: принимается
принятие: принятие, принятием
принять: принятая, принятые
приобретать: приобретает
приоритетный: приоритетной
проблема: проблемы
проведение: проведение, проведения
проводиться: проводится
программа: программа, программы
продвижение: продвижение
продолжить: продолжат
проект: проектам, проекты
происходить: происходило, происходящей
пространство: пространстве
противоречие: противоречиями
протяжение: протяжении
процесс: процессов
прошедшее: прошедшем, прошедшие
проявлять: проявляет, проявлять, проявляя
работа: работе
развивать: развивая
развиваться: развивались
развитие: развития
различный: различных
рамка: рамках
распространять: распространяя
рассматриваться: рассматриваются
расширение: расширения
расширить: расширят
реализация: реализация
реализоваться: реализуется
региональный: региональном
режим: режим
резкий: резкое
результат: результате
республика: республик, республика, республике, республики, республикой
ресурс: ресурс
реформирование: реформирование
решающий: решающим
решить: решены
роль: роли
росмолодёжь: росмолодежью
российский: российский, российских, российское, российской
российско: российско
россия: россией, россии, россия
рубеж: рубежом
русский: русского, русском, русскую
рф: рф
рюо: рюо
с: со
сайт: сайт
сближение: сближения
сверстник: сверстниками
своевременный: своевременной
свой: свои, своими
связанный: связанных
связь: связей, связи
северный: северной
сегодняшний: сегодняшний
семейный: семейных
семья: семей
сентябрь: сентября
система: системе, системы
сказать: сказать
сказываться: сказывается
слабо: слабо
слово: слова
сложность: сложности
слой: слоем
служба: службы
сми: сми
смысл: смыслы
снг: снг
собственный: собственной, собственные
совет: совета, совете
советский: советского
совместный: совместные
совмещение: совмещения
современный: современном, современные
согласно: согласно
соглашение: соглашения
содействие: содействие
создаваться: создаются
создание: создание, созданию
создать: созданы
сопредельный: сопредельных
соревнование: соревнованиях
сотрудничать: сотрудничают
сотрудничество: сотрудничества, сотрудничестве, сотрудничество, сотрудничеству
сохранение: сохранению
сохранить: сохранить
социальный: социальной, социальные, социальных
союз: союза
специфический: специфические
список: список
спорт: спорт, спорта, спорту
спортивный: спортивных
среда: среда, среды
ссср: ссср
становиться: становится
старший: старший
стать: стало
статья: статье
стипендия: стипендии
стоить: стоит
стол: стола, столах
сторона: сторон
страна: стран, странами
строй: строя
структура: структур
студент: студентов
студенческий: студенческих
суверенитет: суверенитета
сфера: сферах, сфере, сферу
такой: таким, такими, такой
там: там
творческий: творческие
тема: тему
тенденция: тенденции
территориальный: территориальной
территория: территорий, территориях
тесно: тесно
тесный: тесное
технический: технические
тибиловый: тибилова
тогда: тогда
тот: том, тот
традиционный: традиционных
традиция: традиции, традициях
требовать: требовали
туризм: туризм, туризма, туризму
уделять: уделяли
уделяться: уделяется
уже: уже
узнать: узнать
уйти: ушедшей
указ: указ
укрепление: укрепление
университет: университет, университета, университете
управленческий: управленческих
упразднить: упразднен
уровень: уровень, уровне
усилиться: усилилось
условие: условий, условиях
устанавливать: устанавливающими
установление: установления
участие: участием, участии, участия
учебник: учебникам
учитывать: учитывать
факт: факт
федеральный: федеральном
федерация: федерации
физический: физического
финансирование: финансированию
формальность: формальностью
формирование: формирование
форум: форум, форумах, форуме
функция: функции
ход: ходе
целостность: целостности
цель: цели
цена: цену
ценность: ценностей
центр: центр
цхинвал: цхинвал
цхинвала: цхинвала
цхинвале: цхинвале
частный: частных
часть: часть, частью
человек: людей, люди
чем: чем
черта: черты
число: числе
что: что
шестнадцать: шестнадцати, шестнадцать
школьник: школьников
школьный: школьного
шос: шос
электронный: электронный
этап: этапе
это: это
этот: этих, эту
эффективно: эффективно
юго: юго
югоосетинский: югоосетинскому
южный: южная, южной
являться: является, являлись, являющиеся
язык: язык, языка, языке
