xан: xан
xозяин: xозяин
автократи: автократии
авторитарн: авторитарное
авторитет: авторитетом
администраци: администрации
азор: азором
альманах: альманах
андреевн: андреевна
аннотация: аннотация
арми: армии
арсенть: арсентьев
атрибутах: атрибутах
атя: атя
бессон: бессонов
бессонов: бессоновым
бог: бога, богов
богатов: богатова
богатыр: богатырь
божеств: божеств
боле: более
больш: больше, больших, большой
большим: большим
борьб: борьба
буд: будь
булгари: булгарии
был: был, была, были, было
быт: быта
важн: важных
важнейшим: важнейшим
важну: важную
варьировалос: варьировалось
вв: вв
век: век, века, векам, веков
вел: веле, вело
велики: великий
великим: великим
верх: верх
верхов: верховного
верховн: верховный, верховным, верховных
верховны: верховные
вершин: вершина
вех: вех
взаимодействия: взаимодействия
взаимоотношения: взаимоотношения
взросл: взрослых
взрослы: взрослые
взят: взяты
вид: вид
видим: видимому
включал: включал, включало
включался: включался
владык: владык
власт: власти, власть
властвовани: властвование
властвования: властвования
властн: властных
влиявш: влиявшая
влиял: влияло
влияни: влияние
вне: вне
внесл: внесли
внеш: внешней
внешн: внешних
внешни: внешние
внутр: внутри
внутренню: внутреннюю
внутренняя: внутренняя
военн: военная, военной, военными, военных
военну: военную
военны: военные
вожд: вождей, вожди, вождь
вождеств: вождества, вождество, вождеству
вождизм: вождизма, вождизму
вождя: вождя
возвеличивани: возвеличивание
возложенны: возложенные
возложивши: возложивший
возможн: возможно
возможност: возможность
возникновени: возникновением
воин: воин
войн: войны
вол: воле
волев: волевым
волжск: волжской
волост: волости, волость
вопрос: вопросов
воспринималис: воспринимались
воспринимался: воспринимался
восточн: восточной
времен: времен, времени
временн: временно
время: время
все: все, всей
всег: всего
всегд: всегда
всем: всем
всеобщ: всеобщем
всех: всех
вскор: вскоре
встречаются: встречаются
вступат: вступать
вступит: вступить
втор: второму
вторжени: вторжение
входил: входило
вхождени: вхождении
вхождения: вхождения
выбираем: выбираемый
вывод: выводу
выделит: выделить
выделяется: выделяется
выделяться: выделяться
вызывают: вызывают
выражени: выражении
выступает: выступает
выступал: выступал, выступало
выступают: выступают
выходил: выходили
вышеперечисленн: вышеперечисленных
вышеупомянут: вышеупомянутых
где: где
геро: героями
героя: героя
гибким: гибким
глав: глав, главе, главу
главн: главной, главным
говорит: говорит
говоря: говоря
голос: голоса
горени: горение
город: город, городом
государств: государств, государства, государствами
государствен: государственного
государственн: государственной, государственный
государственност: государственности
государственну: государственную
государствообразования: государствообразования
граждан: граждан
групп: групп, группами
давал: давал
дальнейш: дальнейшей
дан: данного
данн: данная, данной, данном, данный
дающи: дающий
двоевласти: двоевластие
делегировалис: делегировались
делени: делении
демиург: демиург
демократи: демократии, демократию
демократиче: демократических
деревен: деревень
держателя: держателя
держаться: держаться
деформировал: деформировало
деятельност: деятельность
длитель: длительного
длительн: длительное
до: до
добился: добился
должен: должен
дом: дом
домонголь: домонгольский
доступн: доступна
древ: древней
древнейш: древнейших
древнемордовск: древнемордовской
друг: других, другого, другой
другим: другими
другу: другую
дружин: дружина, дружину, дружины
дружинник: дружинники
европ: европе, европы
его: его
еди: единого
един: единое
единиц: единицей
единовластн: единовластный
ей: ей
ему: ему
естественн: естественно
ефимов: ефимова
ещё: ещё
жизн: жизни
жрец: жрецов
забыт: забытым
зависимост: зависимости
задач: задач, задачам
закладывал: закладывали, закладывало
заключат: заключать
закрепилос: закрепилось
закрепляется: закрепляется
закреплял: закрепляло
закреплялис: закреплялись
закрепляяс: закрепляясь
заложничеств: заложничества
запис: записи
зарождаться: зарождаться
зат: затем
зачасту: зачастую
защитник: защитниками
здес: здесь
земел: земель
земл: земли
земны: земные
знани: знаний
знат: знать
знать: знатью
значим: значимых
значимост: значимости, значимость
значительн: значительно, значительной
значительны: значительные
знающ: знающего
зон: зоной
зрения: зрения
играет: играет
идеологическ: идеологического
идиоматическ: идиоматическом
иерархи: иерархии
из: из
избрани: избрание
изд: изд
издательств: издательство
изменения: изменения
изначальн: изначально
изображается: изображается
изображаются: изображаются
изолированн: изолированными
им: им
имел: имела, имело
имелис: имелись
имен: именем
именн: именно
имеющ: имеющего
имуществ: имущества
имя: имя
иная: иная
индивидуализаци: индивидуализации
ине: ине
инешкипаз: инешкипаза
ино: иной
институт: институтов, институты
интеграци: интеграции
интеграционн: интеграционной
интерес: интерес, интересов
интересен: интересен
интересн: интересное
инязор: инязор, инязоро, инязоров, инязоры
исключительн: исключительно, исключительное
исполнял: исполнял
использовал: использовало
использовани: использование
исследованиям: исследованиям
истори: истории
историче: исторический, исторических
историческ: исторически
исторически: исторические
история: история
исходя: исходя
их: их
кажд: каждого, каждое, каждой, каждом
как: как
каназор: каназор
качеств: качеств, качестве
кем: кем
кланов: кланово
ключевы: ключевые
кн: кн
княз: князей, князь
князь: князьями
князья: князья
ко: ко
ковлер: ковлер
коллектив: коллективов
компактн: компактной
компетенци: компетенцию
конц: концу
кончен: конченом
котор: которая, которого, которое, которой, который, которыми, которых
которы: которые
кра: край
края: края
кров: крови
кровн: кровному
крупн: крупных
крупнейш: крупнейших
ксения: ксения
куд: куд, кудо
кузнец: кузнец
культ: культов
культур: культура
латинск: латинского
лидер: лидер, лидера
лит: лит
литератур: литературы
лиц: лицо
люб: любой
люд: людей, люди
максимальн: максимальное
мария: мария
маска: маскаев
материальн: материальном
материальны: материальные
мер: мере
мест: местного, место
местн: местное, местной
метод: метода
мироустроител: мироустроитель
мисси: миссию
мног: многих
многочисленн: многочисленных
многоэтапн: многоэтапный
мог: мог
могл: могла
можн: можно
мокш: мокши
мокшанс: мокшансой
момент: момент, момента
монголь: монгольских
морд: морд
мордв: мордва, мордвы
мордов: мордовская, мордовский, мордовских
мордови: мордовии
мордовия: мордовия
мордовск: мордовского, мордовской, мордовском
мордовски: мордовские
мордовску: мордовскую
мужчин: мужчинам, мужчины
муниципалитет: муниципалитет, муниципалитета
мы: мы
наблюдалас: наблюдалась
над: над
наделен: наделен
названи: название
названия: названия
наиболе: наиболее
наименовани: наименовании
накапливаться: накапливаться
народ: народ, народа, народного, народов, народу
народн: народная, народном, народный, народных
народност: народность
нарост: наростом
населени: населением
населения: населения
наскольк: насколько
наследовалос: наследовалось
наследовани: наследование
наследования: наследования
наследственност: наследственности
насон: насонов
научн: научный
находивш: находившая
находил: находили
находит: находит
националь: национального
национальн: национально, национальной
национальну: национальную
национальны: национальные
начал: начала, начали, начало
началах: началах
начин: начиная
начинает: начинает
начинал: начинало
начинают: начинают
нашл: нашло
независим: независимых
ней: ней
нельзя: нельзя
нем: нему
необходим: необходимо, необходимыми
необходимост: необходимость
нескольк: нескольких, несколько
ни: ни
них: них
нишк: нишке
нов: новое, новой
нормотворче: нормотворческий
носител: носителем
обеспечени: обеспечение
обладал: обладали
обозначени: обозначение
образ: образом, образы
образован: образовано
образовани: образованием, образованию
образования: образования
обусловлен: обусловлена
обширн: обширной, обширными
общ: общем
обще: общее
обществ: общества, обществами, обществе, общество
обществен: общественного
общественн: общественно, общественное
общи: общий
общин: общин, общинам, общинного
общинн: общинно, общинному, общинным
общинник: общинников
общинну: общинную
общност: общностей, общности, общность
общность: общностью
объ: объем
объединени: объединение, объединении, объединений
объединения: объединения
обыча: обычаев
обычн: обычно
обязан: обязано
обязанност: обязанность
обязательн: обязательно
огарёв: огарёва
огромн: огромное
одежд: одежда
одн: одной, одну
однак: однако
означал: означало
оказывает: оказывает
окрашенн: окрашенный
олеговн: олеговна
он: он
она: она
они: они
оно: оно
оперативн: оперативных
опиралос: опиралось
опираяс: опираясь
описани: описании
ополчения: ополчения
определени: определение
определенны: определенные
определяется: определяется
опыт: опыт
орган: орган, органы
организаци: организации, организацию
организационн: организационная
организация: организация
организует: организует
основ: основе, основного, основу, основы
основани: основании
основанну: основанную
основн: основной, основным, основных
основны: основные
особ: особая, особое, особой, особый, особыми, особых
особенност: особенностей, особенности, особенностями
остальн: остальное, остальных
от: от
ответ: ответом
ответственн: ответственных
отличалис: отличались
отличающийся: отличающийся
отметит: отметить
отмечает: отмечает
отмечается: отмечается
относиться: относиться
отношени: отношений
отражени: отражение
оформления: оформления
оцязор: оцязор
очеред: очередь
пантеон: пантеоне
патриархальн: патриархальных
перв: первый, первых
первобытн: первобытных
перву: первую
переводится: переводится
перейдет: перейдет
перекраивал: перекраивали
перераспределительн: перераспределительная
переход: переход, перехода, переходе, переходу
период: период, периоде, периоду, периоды
песен: песен
песня: песня
песнях: песнях
пикторов: пикторова
пиньг: пиньге
план: план, плане
планах: планах
пласт: пластов
племен: племен, племени, племенного
племенн: племенная, племенной, племенными, племенных
племенны: племенные
племя: племя
племён: племён
плеч: плечи
повлиял: повлияло
повод: поводу
подготовк: подготовки
подключит: подключить
подкуп: подкупа
подоби: подобие
подсист: подсистем
подчеркнут: подчеркнуть
подчинения: подчинения
подчинивши: подчинивший
подчиняяс: подчиняясь
позволял: позволяло
покш: покш
политик: политико
политическ: политической, политическом
политически: политические
политическим: политическим, политическими
полиэтничн: полиэтничный
полн: полной
полномоч: полномочиями
полномочия: полномочия
полноправны: полноправные
полность: полностью
положени: положение
положил: положила, положили
получени: получение
получит: получить
полчищ: полчищ
пользующимися: пользующимися
понятия: понятия
попирал: попирало
порядк: порядка
поселени: поселение, поселений
посл: после
последующ: последующего, последующем
посох: посох
посредств: посредством
постепен: постепенного
постепенн: постепенно, постепенном
постоянн: постоянной
постоянну: постоянную
построени: построение, построении
построения: построения
построенн: построенная
потестарн: потестарных
потребност: потребностями
потребовал: потребовала
похож: похожей
почитат: почитать
поэм: поэма
поэт: поэтому
появилас: появилась
появлени: появление
появляется: появляется
появляются: появляются
прав: право
правил: правило
правител: правитель, правителями
правления: правления
правов: правовой, правовым
правовы: правовые
правомочн: правомочным
практическ: практически
превосходивш: превосходившей
предания: предания
предводительств: предводительство
пределах: пределах
предпосылк: предпосылки
представлени: представлении
представляет: представляет
предшествующ: предшествующего
предшествующу: предшествующую
прежд: прежде
преимуществ: преимущества
преобразования: преобразования
преобразуется: преобразуется
прервал: прервало
претерпевал: претерпевала
преференци: преференций
при: при
приближенн: приближенный
приведенн: приведенная
приводил: приводило
приводит: приводит
признак: признаку
примитивн: примитивная, примитивной
принимал: принимали
принуждения: принуждения
принцип: принцип
принципах: принципах
принципиальность: принципиальностью
приняти: принятии, принятию
принятия: принятия
приобрел: приобрела
приходим: приходим
причин: причина
пришл: пришло
проблем: проблемы
проведения: проведения
продолжалос: продолжалось
произведениях: произведениях
производн: производное
происходил: происходил, происходило
происходит: происходит
прослеживается: прослеживается
прослеживаться: прослеживаться
прост: просто
просьб: просьбе
протекавшим: протекавшим
противовес: противовес
протяжени: протяжении
процесс: процесс, процесса, процессом
проче: прочее
прочн: прочно
проявляется: проявляется
проявлялас: проявлялась
проявлялос: проявлялось
пургас: пургас
пургасов: пургасова, пургасовой, пургасову
пуреш: пуреш
пуст: пусть
пут: путем
равенств: равенства
равноправн: равноправных
радаев: радаева
развития: развития
разделени: разделение
различн: различных
разниц: разница
разнообразны: разнообразные
разросшимися: разросшимися
разумеется: разумеется
ранн: ранних
ранни: ранние
распределительну: распределительную
рассматриваются: рассматриваются
реализовыват: реализовывать
реализуя: реализуя
реальны: реальные
религиоз: религиозного
религиозн: религиозной
религиозну: религиозную
религиозны: религиозные
республик: республики
решени: решение, решений
род: род, родов, родом
родов: родовому, родовыми, родовых
родоплеменн: родоплеменной
родств: родству
родственник: родственник, родственники
рол: роль
росс: россией
росси: россии
ротничеств: ротничества
рубеж: рубеже
руках: руках
руководил: руководил
рус: руси, русь
русски: русские
русским: русскими
рф: рф
ряд: ряд, ряда
сам: самых
самостоятельн: самостоятельными
самостоятельност: самостоятельность
самоуправлени: самоуправление, самоуправлению
самоуправления: самоуправления
самоуправляем: самоуправляемой, самоуправляемых
саранск: саранск
сб: сб
свидетельствуют: свидетельствуют
сво: свое, своего, своей, своему, свою
своеобразн: своеобразное
свойственн: свойственно
связ: связей, связи
себ: себе
себя: себя
сельским: сельскими
сем: семей
семейств: семейств
середин: середины
сил: силу, силы
сильн: сильным
сильне: сильнее
символик: символикой
систем: системе, системы
сияжар: сияжар
сказат: сказать
складывал: складывали
складывалис: складывались
складывания: складывания
складываться: складываться
славянск: славянского
следующ: следующем
слов: слова, слову
сложившихся: сложившихся
сложн: сложная
служб: служба, службу
служения: служения
случа: случае
сначал: сначала
со: со
соб: собой
собрани: собрание, собрании
собраниях: собраниях
собственн: собственно, собственным, собственных
собственник: собственником
собственну: собственную
совершенн: совершенно
совершенств: совершенством
совет: совет, совету
совпадает: совпадает
совс: совсем
согласн: согласно
создал: создали
созданн: созданным
создающе: создающее
сознани: сознании
соответствовал: соответствовали
соплеменник: соплеменниками, соплеменники
сопровождалос: сопровождалось
соседним: соседними
сословн: сословное
сосредоточился: сосредоточился
состав: состав
составлял: составляли
состоявш: состоявших
состояни: состоянии
состоящ: состоящей
сотрудничеств: сотрудничества
социальн: социально, социальным, социальных
союз: союз, союзам, союзами, союзов, союзы
специфик: специфика
список: список
сплочения: сплочения
сплоченн: сплоченным
сред: среди
средств: средства
ставил: ставили
ставш: ставшая
стади: стадии
стал: стала, стали, стало
становится: становится
становлени: становлении
становления: становления
старейшин: старейшин, старейшина, старейшинами, старейшиной
старик: старик, стариками
статус: статус
стать: статье
стоит: стоит
сторон: стороны
стоял: стоял, стояли
строительств: строительства
структур: структурам, структуру, структуры
структурированн: структурированная
студент: студент
ступен: ступени
стык: стык
субъект: субъекта, субъектов
суверенну: суверенную
судебну: судебную
сужения: сужения
суперсоюз: суперсоюзы
суперсоюзах: суперсоюзах
существенн: существенно
существовал: существовала
существует: существует
сход: сход
сходк: сходки
счёт: счёте
так: такая, таких, такое
таки: такие
таким: таким
татарск: татарского
тверд: твердей
текш: текш
текштя: текштяй
тем: тем
тенденция: тенденция
теори: теории
тепер: теперь
территор: территорией, территориями
территори: территории, территорий
территориаль: территориального
территориальн: территориальное, территориальным
тех: тех
течени: течением
титул: титула, титулы
тмутаркан: тмутаркань
тольк: только
том: том
тот: тот
точк: точка
точне: точнее
традиционн: традиционная
трансформаци: трансформации, трансформацию
трансформировалис: трансформировались
требовал: требовали
трети: третий
трех: трех
три: три
трудолюби: трудолюбием
тюркск: тюркского
тюшт: тюште, тюшти
тюштен: тюштень
тюштя: тюштя
тюштян: тюштян, тюштянский, тюштянь
уважени: уважением
угорск: угорского
угорски: угорские
угроз: угрозой, угрозы
уже: уже
укреплени: укреплению
укрепленн: укрепленных
укрепляющ: укрепляющих
укрупнени: укрупнение
умом: умом
университет: университет, университета
уникальн: уникальный
уникальны: уникальные
управлени: управление, управлении
управления: управления
уровня: уровня
уровнях: уровнях
ускорял: ускоряло
условия: условия
усложнени: усложнение, усложнением, усложнению
усложняющиеся: усложняющиеся
устанавливающейся: устанавливающейся
устаревш: устаревшему
устойчив: устойчивым, устойчивых
устройств: устройстве
уступил: уступили
утрачиват: утрачивать
участвующ: участвующих
участи: участие
участник: участники
учитываются: учитываются
фактор: фактором
факторах: факторах
физическим: физическим
финн: финно
фольклор: фольклор, фольклора, фольклоре, фольклорного
фольклорн: фольклорных
форм: форм, форма, форме, формой, формы
формировани: формирование
формирования: формирования
формирующиеся: формирующиеся
функц: функцией, функциями
функци: функции, функций
характер: характер, характером
хозяин: хозяином
хозяйственн: хозяйственных
хотелос: хотелось
хотя: хотя
храбр: храбрым
хронологическ: хронологически
худ: худ
цар: царь
целостност: целостности
цель: целью
целям: целям
част: части, часть
частност: частности
чег: чего
человек: человека
чем: чем
числ: число
член: членами
что: что
чуд: чуди
чудотворец: чудотворец
экономиче: экономических
экономически: экономические
экономическу: экономическую
эпиче: эпическая, эпических
эпос: эпос
эрз: эрзи
эрзя: эрзя
эта: эта
этап: этап, этапы
этих: этих
этниче: этнических
этническ: этническому
этническим: этническими
этнокультурн: этнокультурная
этнокульурн: этнокульурными
этнотерриториальн: этнотерриториальными
это: это, этой
этог: этого
этом: этом
юрченк: юрченков
являлас: являлась
являлос: являлось
являлся: являлся
явн: явно
язык: языка
языков: языковой
языче: языческих
ярк: яркая, ярко
