mоскв: mосква
абсолютизм: абсолютизма
абсолютистским: абсолютистским
автономи: автономии, автономию
автор: автором
автореф: автореф
адаптировал: адаптировали
администраци: администрации
академи: академии, академий
академическ: академической, академическом
академически: академические
академия: академия
академиям: академиям
активизаци: активизации
активн: активно, активное, активному
активност: активности, активность
активность: активностью
актуальност: актуальность
акци: акции
александрович: александрович
альманах: альманах
амбици: амбиции
анализ: анализ
анализируя: анализируя
аргумент: аргументы
атрибут: атрибутов
бедн: бедны
безразличн: безразлично
безрук: безруков
бесплат: бесплатного
библиотек: библиотека
благодаря: благодаря
благонадёжност: благонадёжности
благотворительны: благотворительные
боле: более
болезн: болезнями
больш: больше, большое
большевист: большевистское
большинств: большинство
борьб: борьбе, борьбу
боялис: боялись
будущ: будущей
буржуаз: буржуазного
буржуазн: буржуазной
был: был, была, были, было
бюджет: бюджета
важн: важным, важных
важност: важность
важну: важную
вахтеров: вахтерова
вв: вв
вдохновленны: вдохновленные
век: век, века, веков
взгляд: взглядов
взыскани: взысканий
видел: видели
вишленков: вишленкова
вклад: вклад
включ: включая
владиславовн: владиславовна
власт: власть
влияет: влияет
влияни: влияние, влиянием
вложенны: вложенные
внедрени: внедрению
внедрения: внедрения
внесл: внесли
внест: внести
внимани: внимание
внося: внося
вовлеченн: вовлеченными
воздействия: воздействия
возможност: возможность
возрастал: возрастала
войн: войны
вопрек: вопреки
вопрос: вопрос, вопросами
восприяти: восприятии
восстановил: восстановили
времен: временем, времени
временн: временной, временных
время: время
все: все
всеобщим: всеобщим
втор: второй
вуз: вузы
выбирал: выбирали
вывод: выводу
выглядит: выглядит
выдающимися: выдающимися
выдвигал: выдвигали
выделялис: выделялись
выделяться: выделяться
вызвал: вызвало
вып: вып
выражени: выражение
высказывается: высказывается
высок: высокой
выступ: выступая
выступал: выступал
выступит: выступить
высш: высшая, высшего, высших
высше: высшее
высши: высшие
высшим: высшим
выш: выше
галиуллин: галиуллина
ганелин: ганелин
глазах: глазах
глубин: глубинного
год: годом
годах: годах
голод: голодом
горн: горное
государств: государства
государствен: государственного
государственн: государственной, государственный
гражданск: гражданской
гришунин: гришунина
групп: группа
давн: давних
даж: даже
дал: дали
дан: данного
данн: данный
дат: дата
движени: движение
движения: движения
движениях: движениях
действи: действий
демографическ: демографического
демократ: демократ, демократов, демократы
демократи: демократии
демократиче: демократических
демократическ: демократической
демонстрируя: демонстрируя
дет: дети
деятел: деятелей
деятельност: деятельности, деятельность
диссер: диссер
диссертаци: диссертаций
дисциплинарн: дисциплинарных
добиться: добиться
доверия: доверия
дополнительн: дополнительно
достижени: достижению
достоинств: достоинство
доступн: доступно
друг: друг, друга
други: другие
духовенств: духовенства
духовн: духовная
духовны: духовные
его: его
един: единым
единодуши: единодушие
ее: ее
её: её
желани: желание
жизн: жизни, жизнь
жизнь: жизнью
забастовках: забастовках
забастовок: забастовок
заведени: заведений
заведения: заведения
зависел: зависели
зависет: зависеть
закон: закону
законны: законные
закономер: закономерного
занималис: занимались
занимаяс: занимаясь
запад: западе
запрещенн: запрещенных
зарубежн: зарубежными
затрагивающи: затрагивающие
зачасту: зачастую
защит: защите
значени: значение
значимост: значимость
значительн: значительный
значительны: значительные
иван: иванов
игр: играя
иде: идеей, идеи, идей
идеолог: идеологией
идеологи: идеологии
из: из
известност: известность
известны: известные
изменени: изменении
изменения: изменения
измучен: измученного
изолироват: изолировать
ил: ил
имел: имели
именуем: именуемых
императорск: императорского
импери: империи
империя: империя
инач: иначе
инициатив: инициативы
иностранн: иностранным
институт: институт, институты
интеллигенци: интеллигенции
интеллигенция: интеллигенция
интерес: интерес, интересов
интересн: интересно
иркут: иркутский
иркутск: иркутск
исключ: исключая
использования: использования
испытывал: испытывало
исследовал: исследовали
исследования: исследования
исследовател: исследователей, исследователи
исследуя: исследуя
истор: истор
истори: истории
историче: исторический, исторических
история: история
истощенн: истощенный
исходя: исходя
итог: итог
их: их
кадетски: кадетские
кадр: кадров
кажд: каждым
казённокоштн: казённокоштных
казённокоштны: казённокоштные
как: как
канд: канд
картин: картина
карцер: карцера
карьер: карьеры
качеств: качество
класс: класса, классов
ключ: ключ, ключом
ключев: ключевого, ключевым, ключевых
ключевы: ключевые
ковальченк: ковальченко
когд: когда
консервативн: консервативному
консерватор: консерваторы
конструктивн: конструктивной
контекст: контекста, контексте
контрол: контроль
конференци: конференции
конц: конца, конце, концом
корн: корнями
корпоративн: корпоративной
корпорация: корпорация
корпус: корпуса
котор: который, которых
которы: которые
критик: критики
критическ: критически
критическу: критическую
круг: круги
кто: кто
культур: культуры
культурн: культурное, культурной, культурных
культурны: культурные
либерал: либерал, либералы
либеральн: либеральной
либеральны: либеральные
литератур: литературы
личн: личное, личной
лиш: лишь
лучши: лучшие
люд: людей, люди
малозаметн: малозаметна
марин: марина
марксист: марксистов
массовы: массовые
масштаб: масштаба
материаль: материального
медик: медико
межвузов: межвузовский
межд: между
меньш: меньшая
мир: мира
митингах: митингах
мнени: мнение, мнению
мнения: мнения
многи: многие
мог: мог
молод: молодого, молодой, молодых
молодеж: молодежи, молодежь
монархически: монархические
монолитност: монолитности
морал: морали
москв: москва
московск: московского, московскому
мотив: мотивом
мысл: мыслей
набирал: набирали
наиболе: наиболее
наибольшу: наибольшую
накопител: накопителями
накоплени: накоплению
направлял: направляли
напрасн: напрасны
напротив: напротив
наряд: наряду
наследи: наследие
настойчивост: настойчивости
насчитывал: насчитывала
насчитывалос: насчитывалось
наук: наук, наука, науки
науч: научного
научн: научное, научных
находилос: находилось
националь: национального
начал: начала, начале, началом
началеxx: началеxx
нашл: нашло
недовольств: недовольству
независимост: независимости
некоторы: некоторые
нелегальны: нелегальные
нем: нем
необоснованн: необоснованному
необходимост: необходимости, необходимость
несмотря: несмотря
несостоятельност: несостоятельность
нестор: нестор
ниж: ниже
низш: низшего
никола: николаю
них: них
нов: новый, новых
норм: норм
обладающ: обладающего
област: области
областях: областях
облик: облик
обновлени: обновлению
оборот: обороты
образ: образ, образом
образовани: образование, образованием
образования: образования
образованност: образованности
образовательн: образовательный
образовательну: образовательную
образовательны: образовательные
обращал: обращало
обращения: обращения
обусловлен: обусловлена
обусловленн: обусловленный
обучал: обучали
обучени: обучение
общ: общего, общему
общепринят: общепринятое
обществ: общества, общество
обществен: общественного
общественн: общественной, общественном
общественност: общественности
общественну: общественную
объединени: объединений
объединялис: объединялись
огн: огнем
ограничен: ограниченного
одержим: одержимы
однак: однако
одним: одним
однородн: однородным
оказывалос: оказывалось
окружен: окружен
они: они
оплат: оплате
оплачивал: оплачивал
оппозиционн: оппозиционных
определяющ: определяющих
определяяс: определяясь
опыт: опыт, опыта
организац: организацией
организаци: организации
ориентированны: ориентированные
осн: основ
основ: основой, основы
основн: основном
основны: основные
особенност: особенности
осознав: осознав
оставаться: оставаться
остатк: остатки
от: от
ответственн: ответственный
отводил: отводили
отголосок: отголосок
отдавал: отдавали
отказавшис: отказавшись
отказываяс: отказываясь
отметит: отметить
отмечают: отмечают
относился: относился
отношени: отношении
отражен: отражено
отсутствия: отсутствия
очевидн: очевидным
падени: падению
параллельн: параллельно
партиям: партиям
передов: передовой
переход: переходу
период: период
петербург: петербург
плавн: плавное
побудил: побудило
повседневн: повседневной
повседневност: повседневность
повышения: повышения
под: под
подводя: подводя
подготовк: подготовке, подготовки
поддержат: поддержать
поддерживал: поддерживало
поддержк: поддержки
подкреплен: подкреплено
подрывал: подрывало
подтверждени: подтверждение
подход: подходов, подходу
подчеркив: подчеркивая
подчеркивает: подчеркивает
подчеркнул: подчеркнуло
подчиняться: подчиняться
позволит: позволить
позволял: позволяло
позици: позиции
поиск: поиск
показывает: показывает
показывал: показывали
поколени: поколений
поколения: поколения
пол: поле
полагал: полагали
политик: политике, политики, политиков
политиче: политических
политическ: политической, политическом
политически: политические
полицей: полицейских
половин: половине, половины
положени: положении
положения: положения
положительн: положительное
получаем: получаемого
получени: получение
получил: получили
получит: получить
понят: понять
популярн: популярны
попытк: попытки
посл: после
последняя: последняя
последующ: последующей
постепенн: постепенно
постоянн: постоянный
постулат: постулаты
пот: потому
потенциал: потенциала
потомк: потомки
потребност: потребность
потрясениям: потрясениям
появилис: появились
прав: прав, права
правительств: правительства
превратилис: превратились
превращ: превращая
предоставит: предоставить
предпочтени: предпочтение
представител: представителей, представители
представителям: представителям
преобладал: преобладали
преобразовани: преобразовании
преобразованиям: преобразованиям
престиж: престиж
привел: привели
привилегированн: привилегированных
привлекл: привлекло
придавал: придавали
придерживалис: придерживались
придерживаются: придерживаются
придерживающихся: придерживающихся
признават: признавать
примерн: примерно
принадлежащи: принадлежащие
принадлежност: принадлежность
принцип: принципов
принят: принять
принятия: принятия
приоритетн: приоритетной
присяг: присягу
приходят: приходят
причин: причины
проведени: проведение
программах: программах
прогресс: прогресс, прогресса
продвиг: продвигая
продолжал: продолжала, продолжали
прозрел: прозрели
произведени: произведений
происхождени: происхождением
происхождения: происхождения
пролетариат: пролетариате
промышленност: промышленности
протест: протестного
протестн: протестных
против: против
противопоставляяс: противопоставляясь
проходил: проходили
процесс: процесс, процессов, процессы
проч: прочих
проявил: проявили
проявился: проявился
публикаци: публикации
публицист: публицистов
пут: пути, путь
пыталос: пыталось
раз: раз
развити: развитие, развитию
развития: развития
разделялос: разделялось
различия: различия
различн: различным, различных
разн: разных
разнообразн: разнообразным
разнородность: разнородностью
разночинц: разночинцев
разочаровани: разочарование
распространени: распространению
распространенн: распространенному
распространялся: распространялся
распуть: распутье
рассматривал: рассматривали
рассматриваются: рассматриваются
рассмотрени: рассмотрение
раст: расти
растущ: растущей
расширен: расширены
революци: революции, революцию
революционн: революционное, революционным, революционными, революционных
регламентирующ: регламентирующей
редактор: редактор
режим: режимом
результат: результаты
репресси: репрессий
реформ: реформ, реформам
решимост: решимости
рол: роли, роль
росл: росла
росси: россии
россий: российская, российских, российское
российск: российского, российской
российски: российские
российским: российскими
рост: роста
ротмистр: ротмистров
рубеж: рубеже
рус: русский, русских
русск: русского
русски: русские
рф: рф
сам: сама, сами, самым
самобытн: самобытный
самодержави: самодержавие
самоорганизаци: самоорганизации
самостоятельн: самостоятельно
санкт: санкт
сборник: сборник
сво: свое, своего, своей, свои, своих, свой, свою
свобод: свободу, свободы
свободн: свободной
своекоштн: своекоштными
своекоштны: своекоштные
связ: связи
священник: священников
себ: себе
сегодня: сегодня
сектор: секторе
сем: семей
серг: сергей
середин: середины
систем: система, системы
сказат: сказать
скептицизм: скептицизм
склонялис: склонялись
скрыт: скрытый, скрытых
сло: слоев, слой
слов: слова
слоя: слоя
служб: службы
смешанн: смешанная
смотря: смотря
смысл: смысла
сниж: снижая
со: со
собственн: собственный
события: события
событиях: событиях
совершенн: совершенно
совет: советом, советская
согласовани: согласование
создаваемы: создаваемые
создани: созданию
соиск: соиск
сокол: соколов
сокурсник: сокурсниками
солидарност: солидарности
сообществах: сообществах
сословия: сословия
сосредотачиваяс: сосредотачиваясь
состав: состав
состоял: состояла
состоятельн: состоятельных
соци: социо
социал: социал
социаль: социального
социальн: социальная, социальной, социальный, социальным, социальных
союзн: союзным
союзник: союзников
специалистах: специалистах
специальност: специальности, специальность
список: список
способ: способного
способствовал: способствовали, способствовало
сравнени: сравнение, сравнению
сравнительн: сравнительный
сред: среда, среде, среди, среду, среды
средн: среднего
средств: средств
стал: стал, стали, стало
стандарт: стандартам
становится: становится
стать: статье, статьи
степ: степ
степень: степенью
стереотип: стереотипа, стереотипами
сторон: стороны
стоял: стояли
стран: стране, страны
стратеги: стратегии
стремившихся: стремившихся
стремилис: стремились
стремительн: стремительное
стремлен: стремлениями
стремлени: стремление, стремлении, стремлению
строг: строгого
студент: студент, студента, студентам, студентами, студентов, студенты
студенче: студенческая, студенческий
студенческ: студенческого, студенческой
студенчески: студенческие
студенческу: студенческую
студенчеств: студенчества, студенчество
существования: существования
существует: существует
сущност: сущность
сфер: сфере, сферу
сформирован: сформирована
схожест: схожесть
счет: счет
считал: считали
так: такой
таки: такие
таким: таким
талант: таланты
текст: текст
тем: тем, теми
терентьев: терентьева
тех: тех
типичн: типичный
тог: того
той: той
тольк: только
том: том
традици: традиции, традиций
трансформациям: трансформациям
требовалос: требовалось
труд: трудов
трудност: трудности
трудностям: трудностям
ту: ту
тщетн: тщетно
тысяч: тысяч
тягостны: тягостные
тяжел: тяжелом
убежден: убеждениями
уважени: уважению
удар: ударом
указанн: указанный
улучшени: улучшению
унаследовал: унаследовала
университет: университет, университета, университетов, университетская, университету, университеты
уникальн: уникальное
уникальны: уникальные
уничтожен: уничтожены
упомянут: упомянутого
управления: управления
управляющ: управляющего
уровен: уровень
уровня: уровня
уровням: уровням
усиливалос: усиливалось
усилия: усилия
ускоряя: ускоряя
условия: условия
условиях: условиях
усложнилас: усложнилась
усматривал: усматривали
успеваемост: успеваемости
успех: успеха
устав: устава
устройств: устройства
уступк: уступке
уходящи: уходящие
уч: уч
участвовал: участвовали
участвующим: участвующими
участи: участие, участию
учащиеся: учащиеся
учебн: учебной, учебных
учебны: учебные
учены: ученые
училищ: училища, училище
учреждения: учреждения
учреждениях: учреждениях
фадеев: фадеева
фактор: фактора, факторов
факультет: факультет
феофан: феофанов
философ: философский
финансировалос: финансировалось
финансов: финансового, финансовых
фон: фоне
формировал: формировали
фронт: фронтом
характер: характер
характеризовал: характеризовали
характеризовался: характеризовался
хирургически: хирургические
хирургическим: хирургическим
хотелос: хотелось
хронограф: хронограф
художеств: художеств
цел: цели
цель: целью
ценност: ценности, ценность
центр: центры
центральну: центральную
част: часто
часть: частью
человек: человек, человека
человече: человеческое
чем: чему
через: через
четверт: четверть
чиновник: чиновников
числ: числа, числе, число
численност: численность
что: что
чьи: чьи
широк: широко, широкого
школ: школа, школы
шёл: шёл
щетинин: щетинина
экономик: экономики, экономику
экономическ: экономического
экстремист: экстремистских
электронн: электронная, электронный
элемент: элемента
эпох: эпохи, эпоху
эсер: эсер, эсеры
эти: эти
этик: этики
этих: этих
это: это, этой
этот: этот
является: является
являлас: являлась
являлос: являлось
