автономност: автономности
автор: автор, автора, авторов
аксак: аксаков
аксаков: аксаковых
аксиоматизация: аксиоматизация
актуализаци: актуализации
александр: александра, александре
альтернатив: альтернативы
амбици: амбиций
анализ: анализе
анализируются: анализируются
анализируя: анализируя
аннотация: аннотация
антиреформистски: антиреформистские
апреля: апреля
аргумент: аргументам
аристократ: аристократией
аспект: аспектов
базировавшегося: базировавшегося
базировалис: базировались
без: без
безобраз: безобразов
безусловн: безусловно
безусловну: безусловную
бесспорн: бесспорными
благородств: благородства
ближайш: ближайшая
бог: бог
боле: более
большинств: большинство, большинству
брать: братьев
будущ: будущего
будущност: будущность
бурны: бурные
был: была, были, было
быт: быть
бюрократи: бюрократии, бюрократию
бюрократическ: бюрократического
важн: важно, важный, важным
важнейшим: важнейшим
вв: вв
введения: введения
ведомост: ведомости
век: века, веке
велик: великих, великого
велики: великий
верн: верным
верховн: верховной
вес: весь
вест: весте
весьм: весьма
взаимопонимания: взаимопонимания
взвешенн: взвешенном
взгляд: взгляда
видн: видными
видны: видные
видя: видя
включ: включая
власт: властей, власти, власть
власть: властью
вмест: вместе, вместо
вне: вне
внимани: внимание
внимания: внимания
возможн: возможных
вообщ: вообще
вопрос: вопрос, вопросам, вопросами, вопросе, вопросов, вопросу
воспринимался: воспринимался
восприяти: восприятии
времен: времен
временн: временной
время: время
все: все
всег: всего
вседержительств: вседержительства
всех: всех
встречаются: встречаются
вступал: вступал
всяк: всякого
втор: второй
вторы: вторые
выборн: выборному
вывод: выводов, выводу
выглядит: выглядит
выделени: выделение
выделяется: выделяется
вызвавш: вызвавших
вызов: вызовы
вып: вып
выработан: выработанного
выработат: выработать
выражавшим: выражавшими
выражает: выражает
выраженн: выраженный
выразител: выразителями
высказывал: высказывал
высотах: высотах
выступает: выступает
выступал: выступал, выступали
выш: выше
гармони: гармонии, гармонию
гг: гг
гибел: гибель
главн: главный, главных
год: годы
горазд: гораздо
государ: государю
государств: государства, государством
государствен: государственного
государственн: государственное, государственном, государственный
государственност: государственности, государственность
государя: государя
гражданин: гражданин
граф: графа
греховн: греховная
григорьев: григорьевым
грингмут: грингмут
гуманистическ: гуманистической
гуу: гуу
давыд: давыдов
дан: данного
данн: данной, данный, данных
два: два
движения: движения
дворянск: дворянского
дворянств: дворянства, дворянство, дворянству
декабря: декабря
декларироват: декларировать
делается: делается
демонстрировал: демонстрировал
депутат: депутатов
деятел: деятели
деятельн: деятельное
деятельност: деятельность
диалог: диалога
дискурс: дискурс, дискурса, дискурсе
дискусси: дискуссии, дискуссий
диссонанс: диссонансы
дмитри: дмитрий
до: до
добр: добрым
должн: должна
дом: дом
допетровск: допетровской
дополнилис: дополнились
достаточн: достаточно
достижени: достижении
доц: доц
др: др
древ: древней
дроздов: дроздовым
друг: другой
думается: думается
думск: думской
европ: европы
европейск: европейского
его: его
единиц: единиц, единицы
единоначалия: единоначалия
единственн: единственной
едину: единую
ее: ее
екатерин: екатериной, екатерины
желаем: желаемой
жизн: жизни
задач: задач
заключается: заключается
законосовещатель: законосовещательного
заложенн: заложенных
западн: западной
записк: записка, записки
зародившегося: зародившегося
заслуг: заслуга, заслугам
защищ: защищая
здес: здесь
земл: земле, земли
земск: земскому
знамен: знаменский
значения: значения
значим: значимых
значительн: значительно, значительными
зрения: зрения
иде: идеи, идей, идеями
идеал: идеал, идеала, идеалу, идеалы
идеализация: идеализация
идеалистиче: идеалистическое
идеаль: идеального
идеальн: идеальном, идеальный
идеальны: идеальные
идейны: идейные
идеолог: идеологов
идеологем: идеологемы
идеология: идеология
идея: идея
идеям: идеям
идт: идти
из: из
избегат: избегать
изд: изд
издания: издания
издатель: издательский
изменени: изменение
изменениях: изменениях
изначальн: изначально
илларион: иллариона
иллюстрац: иллюстрацией
им: им
именн: именно
импер: имперский
император: императора
инициатор: инициатор
ино: иной
институт: института, институтами, институтов
интерес: интересов, интересы
иных: иных
исключени: исключением
исконн: исконно
исследовани: исследование
исследования: исследования
исследовател: исследователей
исследуем: исследуемого
истори: истории
историк: историко
историче: историческая, исторический, исторических
историческ: исторически, исторического, исторической
исторически: исторические
историческим: историческим
историческу: историческую
исходя: исходя
итог: итоге
их: их
как: как, какого, какому
каку: какую
канд: канд
карамзин: карамзин, карамзина
карц: карцов
касается: касается
категориче: категорическое
катк: катков
катков: каткова, катковым
кафедр: кафедры
качеств: качестве
киевск: киевского
кире: киреев
киреев: киреева
ключев: ключевым, ключевых
ключевы: ключевые
княз: князь
князя: князя
конкретн: конкретному
консерватив: консервативного
консервативн: консервативная, консервативно, консервативное, консервативной, консервативном, консервативному, консервативный, консервативным, консервативных
консервативны: консервативные
консерватизм: консерватизм, консерватизма, консерватизме, консерватизму
консерватор: консерваторами, консерваторов, консерваторы
константин: константин
конституционн: конституционных
конфликтны: конфликтные
конц: конца
концентрировалос: концентрировалось
концепци: концепцию
концепция: концепция
котор: которой
котору: которую
крестьянств: крестьянства
критик: критике, критиков
критиче: критическое
критическ: критически
критически: критические
крут: крутой
культур: культура
курс: курса
лебед: лебедев
лебедев: лебедева
леонть: леонтьев
леонтьев: леонтьева, леонтьевым
либерал: либералами
либерализм: либерализм, либерализма
либераль: либерального
либеральн: либеральных
либеральны: либеральные
литератур: литературе, литературы
лич: личного
личн: личной, личных
личност: личностей, личности
лиш: лишь
логичн: логичным
лукьян: лукьянов
люб: любого, любой, любым
любим: любимов
манифест: манифеста, манифесте
март: марта
масштабны: масштабные
межд: между
мене: менее
меняется: меняется
меритократи: меритократии
мест: место
мещер: мещерский
мещерск: мещерского
мещерским: мещерским
митрополит: митрополита, митрополитом
мифологи: мифологии
мнени: мнению
мног: многом
модальност: модальности
можн: можно
монарх: монарх, монархов
монархи: монархии
монография: монография
москв: москва
московск: московского
московски: московские
московским: московским
мысл: мысли
мыслител: мыслителей
навязывани: навязывание
наглядн: наглядной
называется: называется
наиболе: наиболее
належал: належало
наличи: наличие
направлени: направление
направления: направления
например: например
напротив: напротив
народ: народ, народа, народного, народом, народу
народност: народности, народность
нарратив: нарративы
наряд: наряду
наследствен: наследственного
настоящ: настоящего
настоящи: настоящие
настроения: настроения
наук: наук, наука, науке
находятся: находятся
национальн: национальных
начавшееся: начавшееся
начал: начал, начала, начале, начало, началу
начальн: начальном
начин: начиная
наш: наш, нашей
небес: небесного
нег: него
негативн: негативно
недовери: недоверием
незыблемост: незыблемости
неко: некоей
некотор: некоторых
нелегк: нелегких
нельзя: нельзя
нем: нем
немаловажн: немаловажной
немыслим: немыслимо
необходимост: необходимости, необходимость
неоднократн: неоднократно
непреходящ: непреходящего
неприяти: неприятие
несовершенн: несовершенная
несогласн: несогласны
нестор: нестор
ни: ни
никол: николая
никола: николае, николаю
николаев: николаевское
николаевск: николаевской
николаевски: николаевские
ним: ними
них: них
нов: нового, новой, новым, новых
нрав: нравов
нравственн: нравственный, нравственным
об: об
обоснованн: обоснованным
обосновыв: обосновывая
образ: образ, образа, образе, образом, образу
образах: образах
образовани: образовании
образц: образцов
образцов: образцовой
обращает: обращает
обращалис: обращались
общеизвестн: общеизвестна
обществ: общества, обществе, обществом
обществен: общественного
общественн: общественно, общественной, общественному, общественных
общин: общинного
объединяет: объединяет
один: один
одн: одно, одного, одной
однак: однако
одним: одним
ознаменовал: ознаменовали
означает: означает
означал: означала
означен: означенного
означенны: означенные
октября: октября
омельченк: омельченко
он: он
оп: оп
опор: опорой, опоры
определяющ: определяющих
опыт: опыт, опыта
ор: ор
орган: органами
орл: орлов
ослабления: ослабления
основ: основа
основах: основах
основн: основное, основных
особ: особо
особенност: особенность
оставалас: оставалась
оставаться: оставаться
острот: остроты
от: от
отверг: отвергая
ответ: ответ, ответа
отец: отец
отечественн: отечественной
отказ: отказ
откровенн: откровенно
отличи: отличие
отличительн: отличительная
отличн: отличных
отметит: отметить
отмечалос: отмечалось
относилис: относились
относительн: относительно
отношени: отношение, отношении, отношений, отношению
отношения: отношения
отношениях: отношениях
отрекающимся: отрекающимся
отрицал: отрицали
отрицани: отрицанию
отрывк: отрывки
отсутствия: отсутствия
официаль: официального
официальн: официальной
охранени: охранением
охранител: охранители
охранитель: охранительного
охранительны: охранительные
оценивает: оценивает
оценивающи: оценивающие
оценк: оценка, оценке, оценки
очеред: очередь
парадигм: парадигме
парламент: парламент, парламента
парламентаризм: парламентаризма
парламентск: парламентского
парламентским: парламентским
перв: первая, первой, первым
перву: первую
первы: первые
переломн: переломным, переломных
перемен: переменам
переход: переход
период: период, периода, периодов
перм: перм, пермь
персонифицировалис: персонифицировались
петерб: петерб
петр: петр, петра, петром, петру
печатн: печатными
письм: письма
победоносц: победоносцев
победоносцев: победоносцева
поведения: поведения
повлиял: повлияли
повод: поводу
поворот: поворот
повреждени: повреждении
погодин: погодин
подавлени: подавлению
подавляющ: подавляющему
подданн: подданных
поддержк: поддержка, поддержку
подоб: подобного
подобн: подобная, подобным
подход: подходе
подходящ: подходящая
подчеркнут: подчеркнуть
подчинения: подчинения
позволившим: позволившим
поздни: поздний
позитивн: позитивной
позиц: позицией
позици: позиции, позиций, позицию
позиция: позиция
поисках: поисках
показан: показано
поколени: поколений
полемизируя: полемизируя
полемик: полемика, полемику
полит: полит
политик: политика, политике, политики
политиче: политическая, политический, политических
политическ: политического, политической, политическом
политическу: политическую
полн: полное
полномасштаб: полномасштабного
полноцен: полноценного
половин: половина, половине, половины
положения: положения
понимался: понимался
понимани: понимание
понимания: понимания
пореформенн: пореформенной
порядк: порядка, порядки
посвященн: посвященными
последни: последние
последню: последнюю
последовательн: последовательным
посредник: посредников
посредничеств: посредничества
почвеннически: почвеннические
почт: почти
появляются: появляются
прав: прав
правительств: правительства
правителя: правителя
правлени: правление, правлению
правления: правления
православи: православие
православн: православной
практическ: практически
предлагал: предлагали
предопределил: предопределили
предреволюционны: предреволюционные
представит: представить
представител: представителями
представительств: представительства
представлен: представлена, представлено
представляется: представляется
представляются: представляются
преимуществ: преимуществу
преобладал: преобладали
преобразовани: преобразований, преобразованию
преобразования: преобразования
престол: престола
при: при
приведши: приведшие
привел: привело
приверженност: приверженность
привест: привести
привилеги: привилегий
придерживалас: придерживалась
придерживалис: придерживались
призван: призван
призм: призму
признават: признавать
пример: примеров
принцип: принцип, принципа, принципе
принципиальн: принципиальном, принципиальных
принципиальну: принципиальную
принявши: принявшие
принят: принять
приобретения: приобретения
природ: природа
присвоения: присвоения
прич: причем
причин: причинам, причиной
пришл: пришли
пришлис: пришлись
проблем: проблемы
проблемах: проблемах
проведени: проведении
программ: программы
прогресс: прогресса, прогрессу
продолжалис: продолжались
проект: проекта, проектов, проекты
происхождения: происхождения
промышленн: промышленном
просвещения: просвещения
против: против
противник: противников
противоречи: противоречие
протяжени: протяжении
проч: прочих
прям: прямое
публицистик: публицистике
путешестви: путешествие
работ: работами
работах: работах
радикал: радикалы
радикальны: радикальные
радищев: радищева
развити: развитии
развития: развития
различи: различие
различия: различия
различн: различным
разн: разному, разным, разными
разниц: разницу
разногласи: разногласий
разногласия: разногласия
рамках: рамках
раньш: раньше
рассматривается: рассматривается
рассматривал: рассматривали
рассматривался: рассматривался
рассмотрени: рассмотрение
рассмотрет: рассмотреть
ргб: ргб
реальност: реальности
реальность: реальностью
революционны: революционные
религиозн: религиозной
репник: репников
реформ: реформ, реформам
реч: речь
род: рода
родов: родового
рол: роли, роль
росси: россии, россию
россий: российский, российских
российск: российского, российской
рус: руси, русская, русский, русских
русск: русского, русской, русском
русским: русским
рф: рф
ряд: ряда
сам: сама, самой, саму
самарин: самарин
самодержав: самодержавного
самодержави: самодержавие
самодержавия: самодержавия
самодержавн: самодержавной, самодержавный
самоуправления: самоуправления
сво: своего, своей, своему, свою
свобод: свободы
сводилис: сводились
свойственн: свойственной
связ: связи
сельскохозяйственн: сельскохозяйственном
середин: середины
сигналъ: сигналъ
сил: силу
симфони: симфонии
скептическ: скептически
скоре: скорее
славянофил: славянофилов, славянофилы
славянофильств: славянофильство
следовательн: следовательно
следует: следует
следующ: следующих
слеп: слепого
слов: слова
сложившейся: сложившейся
служит: служит, служить
смел: смелых
со: со
собрани: собрание
событи: событий
события: события
событиям: событиям
современн: современных
современник: современник
соглашаяс: соглашаясь
созвучия: созвучия
сомнения: сомнения
соотношени: соотношении
соотношения: соотношения
сослов: сословиями
сослови: сословий
сословиям: сословиям
сословн: сословному, сословный
составляющ: составляющей
сохранения: сохранения
сохранит: сохранить
социальн: социально, социальным
социальны: социальные
сочинени: сочинений
сочинения: сочинения
спб: спб
сперанским: сперанским
список: список
стабильност: стабильность
ставк: ставка
стал: стал, стала, стали
стать: статье
стол: столь
столетия: столетия
сторон: стороны
сторонник: сторонниками, сторонники, сторонником
стоят: стоять
стр: строго
страдо: страдою
стран: стран, страны
страхов: страховым
строя: строя
структур: структура, структуру, структуры
структурны: структурные
судьбоносн: судьбоносных
суждения: суждения
сут: сути, суть
существенн: существенно, существенное, существенны
сущност: сущности
сформировавши: сформировавший
сформировалис: сформировались
сформулированн: сформулированной
считавш: считавшего
считал: считал
считат: считать
сыграл: сыграли
та: та
так: таких, такой, таком
таки: такие
таким: таким, такими
таков: таковому, таковым
таку: такую
твёрд: твёрдым
текущ: текущей
тем: тем
тематик: тематики
теори: теории
теряет: теряет
тех: тех
технологи: технологий
типография: типография
тихомиров: тихомирова
той: той
толковани: толкование
том: том
тот: тот
точк: точки, точку
точне: точнее
традици: традиций
традиционалистск: традиционалистской
традиционн: традиционно
транслируем: транслируемого
требоват: требовать
триад: триаду, триады
труд: трудом, труды
тщеславия: тщеславия
уваров: уварова
уваровск: уваровской
уваровску: уваровскую
угроз: угрозу
удовлетворения: удовлетворения
уже: уже
указан: указанного
указывал: указывал
укреплени: укрепление
умеренн: умеренная, умеренно, умеренных
ун: ун
университет: университет, университетская
упор: упор
управления: управления
упрощен: упрощенного
усиливаться: усиливаться
усовершенствовани: усовершенствовании
устав: устава
установк: установку
усто: устоев
устроил: устроил
устройств: устройстве
участи: участие
участник: участниками
учени: учение
учреждени: учреждение, учреждению
учреждениям: учреждениям
фадеев: фадеевым
фигур: фигура
филарет: филарета, филаретом
фокус: фокусе
форм: форма, форме
формировани: формировании
характер: характера, характере
характерн: характерна, характерны
характерны: характерные
хомяков: хомякова
хранительск: хранительского
хранительств: хранительство
хронологиче: хронологических
цар: царем
царств: царства
царя: царя
цел: целого, целом, целых
целях: целях
цен: ценой
цензур: цензуре, цензурного
ценност: ценностей, ценности
ценностн: ценностная
ценностям: ценностям
церкв: церкви
церков: церковь
церковь: церковью
част: части, часто
частност: частности
часть: частью
чащ: чаще
человек: человека
человече: человеческая
человеческ: человеческой
через: через
черновик: черновик
честолюбия: честолюбия
четк: четко
чин: чинам, чинов
числ: числе
что: что
чугун: чугунного
чужд: чуждых
шарап: шарапов
шарапов: шарапова
шишк: шишков
шла: шла
щербат: щербатов
щербатов: щербатова
эволюци: эволюции
элемент: элемент, элементов, элементом
эпох: эпоха, эпохе, эпохи, эпоху
этап: этапе, этапов, этапом
эти: эти
это: этой
этог: этого
этом: этом, этому
юрьевич: юрьевич
является: является
якоб: якобы
