аббревиатура: аббревиатурой
август: августа, августе
авт: авт
активно: активно
актуальность: актуальности
акцентировать: акцентировали
александров: александров, александрова
александрович: александровна
английский: английской
аннотация: аннотация
армия: армии
артиллерийский: артиллерийскую
артиллерия: артиллерия
атака: атаки
бабанин: бабанин
баланс: баланса
батарея: батарею
башня: башни, башню, башня
без: без
бензин: бензин
берлинский: берлинской
берёзовый: березовые
битва: битве
бо: бо
боевой: боевая, боевую, боевые, боевых
бой: боев, бой, бою, боя, боях
более: более
большевик: большевиков
больший: наибольшей
большой: больше, большое, большой
бояться: боялись
брод: брода
брон: броне
бронев: броневых
броневой: броневая, броневой, броневую, броневые
бронезащита: бронезащита, бронезащиту
бронелист: бронелистов
бронестойкость: бронестойкость
бронетанковый: бронетанковой
бронирование: бронирование, бронированием
бронировать: бронированной
бронь: броней, брони
броня: броню, броня
бт: бт
быстроходный: быстроходные
быстрый: быстрого
быть: был, была, были, было, быть
важно: важно
важный: важнейшим
варьироваться: варьировалась
ввязываться: ввязываться
вели: вели
великий: великая, великой
вермахт: вермахта
весить: весил
вести: вел, вела
вестись: велась
весь: всей
вид: видов
виккерс: виккерс
виталий: виталий
влияние: влияние
вместе: вместе
вместо: вместо
вмятина: вмятин
внимание: внимание
вов: вов
военный: военное, военной, военные, военных
возможность: возможность
возможный: возможного
возникнуть: возникла
война: война, войнах, войне, войной, войны
войско: войск
вооружение: вооружение, вооружением, вооружении, вооружения
вопрос: вопрос, вопросов, вопросу
воронцов: воронцова
ворошилов: ворошилов
восточный: восточный
вперёд: вперед
время: времени, время
всегда: всегда
встать: встал
второй: второго, второй
выигрывать: выигрывали
выполнять: выполняли
выпрямить: выпрямлен
выпуск: выпуск
выпускаться: выпускаться
выпустить: выпущена
высота: высота
выстрел: выстрелом
вытянутый: вытянута
выходить: выходить
геологоразведочный: геологоразведочного
геополитический: геополитического
гитлеровский: гитлеровских
гко: гко
главный: главный, главным
глаз: глазами
глубина: глубина
глубоко: глубоко
год: гг, год, лет
гол: гол
горизонт: горизонт
горный: горного
государственный: государственного
государство: государства
град: град
груз: грузами
грузовик: грузовиков
гудериана: гудериан
гусеница: гусеницами
даже: даже
данный: данного, данный
дата: дата
двигатель: двигателя
девятый: девятого
действие: действий, действия, действиях
декабрь: декабря
делать: делало
дело: дела
день: день, дня
деталь: детали
дешёвый: дешевым
дивизия: дивизии
дизельный: дизельного, дизельное
диктовать: диктовала
до: до
довести: довести
довольно: довольно
долгий: долгий
должный: должно, должны
дорога: дороге
достоинство: достоинств
доц: доц
др: др
другой: другие, другое, другой
дуга: дуге
думаться: думается
единственно: единственно
единственный: единственный
еженедельник: еженедельник
железный: железных
желт: желтов
живой: живой
живучий: живучими
завод: завода, заводах, заводе
заграждение: заграждения
заграничный: заграничных
задержать: задержал
заключение: заключение
заметно: заметно
замолчать: замолчать
занять: заняв
запрещать: запрещавшая
запуск: запуска
заставить: заставить
затем: затем
защита: защита, защиту, защиты
защищённость: защищенностью
звезда: звезда
зенитка: зенитки
значение: значение
из: из
изготовить: изготовлены
изготовление: изготовлении
изменение: изменения
изменить: изменили
изучение: изучение
именно: именно
иметь: имел, имела, имея
имя: имени
индекс: индекс, индексом
инженерный: инженерные, инженерных
иной: иную
институт: институт
инструкция: инструкция
иосиф: иосиф
иса: ис
испания: испании
исполниться: исполнилось
использование: использование
использовать: использовали, использовать, используемое
использоваться: использовались
испытание: испытаний, испытания
исследуться: исследуется
история: история
истый: ист
итог: итоге
июль: июле
июнь: июнь
кавэшка: кавэшек
как: как
калибр: калибр, калибра
кампания: кампаний
канд: канд
катаный: катаных
кафедра: кафедра
качество: качества, качестве
кб: кб
кв: кв
кершоу: кершоу
кировец: кировец
кировский: кировского, кировском
класс: классе
клим: клим
ключевой: ключевые
км: км
количество: количество
колмыковы: колмыков
колонна: колонну
командир: командира
командование: командованию
комиссар: комиссаров
комитет: комитета
конец: конце, концу
конечно: конечно
конкретный: конкретной
конструктивный: конструктивными
конструктор: конструктор, конструкторы
конструкция: конструкции, конструкцию, конструкция
контрнаступление: контрнаступлении
конус: конуса
коробка: коробка, коробку
корпус: корпус, корпуса
котина: котин
который: которой, которые, которых
красный: красной
крепкий: крепкую
крест: кресты
кроме: кроме
круговой: круговую
кубинка: кубинке
курский: курской
легкопробивать: легкопробиваемая
ленинград: ленинграде
лист: лист, листов
лита: литой
литература: литературы
литой: литая, литую
лицензия: лицензии
лишь: лишь
лобовой: лобовой
льшуя: льшую
лёгкий: легкий, легкого
май: мае, мая
максимально: максимально
максимум: максимуму
маленький: меньше
мало: мало
малый: меньшей
мамонтов: мамонтов
манёвренность: маневренность
манёвренный: маневренные
март: марта
масса: масса, массе, массу, массы
машина: машина, машине, машины
медленный: медленную
между: между
место: места, место
месяц: месяцев
милена: милена
мировой: мировой
мм: мм
мнение: мнения
много: много
многое: многое
модель: моделей, модели, модель, моделью
можно: можно
мотор: моторов
мочь: мог
мощность: мощность
мощный: мощной, мощные, мощным
мощь: мощью
наглядно: наглядно
надёжный: надежной, надежную
назначение: назначения
называть: называемый, называли, называют
накануне: накануне
наклон: наклон, наклона
направить: направили
народ: народа
народный: народных
наступательный: наступательных
наталья: наталья
наука: наук
научный: научный
находиться: находившихся
начало: начала, начале
наш: наш, нашего, нашей, наши, наших
невредимый: невредимы
невысокий: невысокую
недоработка: недоработки
недостаток: недостаткам, недостатками, недостатков
некоторый: некоторые
немедленно: немедленно
немец: немцев, немцы
немецкий: немецкие, немецкими, немецких
немного: немного
немой: нем
несколько: несколько
несмотря: несмотря
неуязвимый: неуязвимыми
никогда: никогда
новация: новациями
новый: новая, нового, новой, новую, новых
нос: нос
носовой: носовой
нужный: нужны
о: об
обеспечение: обеспечении
обеспечивать: обеспечивало
обеспечить: обеспечить
обзор: обзор
обнаружиться: обнаружилось
обозрение: обозрение
оборона: обороны
оборонительный: оборонительных
образец: образцы
обращение: обращения
обречь: обречен
обстановка: обстановки
обстрел: обстрел
общий: общей, общими
объективный: объективные
огнев: огневых
огневой: огневой
огонь: огонь
ограниченный: ограниченную, ограниченный
огромный: огромное
один: один, одна, одни, одним, одними
одиночный: одиночном
одновременный: одновременным
оказать: оказавшие, оказал
оказаться: оказалась
окончание: окончания
он: его, он
она: ее, она
они: им, ими, их, ними, они
оперативно: оперативно
оперативный: оперативной
операция: операции, операциях
оптимальный: оптимальное, оптимальной
опыт: опыт
опытный: опытные
организация: организации
орджоникидзе: орджоникидзе
оригинальный: оригинальная
орудие: орудием, орудия, орудиями
оружие: оружия
оскол: оскол
оснащение: оснащении
основа: основу
основное: основном
основной: основные
основный: основное
особенно: особенно
особенность: особенностями
особо: особо
оставаться: остаются
оставлять: оставляли
остаться: остались
осуществляться: осуществлялось
от: от
ответный: ответный
отечественный: отечественная, отечественной
отличаться: отличался
отметить: отметить
отмечаться: отмечается
отнести: отнести
отправить: отправили
отражать: отражал
отразить: отражены
отрокова: отрокова
очень: очень
павлов: павлов
панцерваффа: панцерваффе
параллельно: параллельно
первый: первая, первые, первый
перед: перед
передача: передач
перезарядка: перезарядку
перестать: перестали
период: период
пехота: пехоты
плита: плиты
победа: победы
победный: победный
поверхность: поверхности
повоевать: повоевать
повысить: повысить
под: под
подвижность: подвижность
подобный: подобного
подтащить: подтащив
подтверждать: подтверждают
подъём: подъема
пожаробезопасный: пожаробезопасным
позаимствовать: позаимствовали
позволить: позволили, позволило
поздний: позже
позиция: позицию
показ: показа
показать: показал, показаны
полагать: полагают
поле: поле, полях
полигон: полигоне
полигонный: полигонные
полуавтоматический: полуавтоматическую
получить: получил, получила
попасть: попали
портал: портал
поскольку: поскольку
после: после
послевоенный: послевоенного
последний: последнего, последние
последующий: последующее
постановление: постановление
потерять: потеряло
потому: потому
потребность: потребность
потребовать: потребовали
потребоваться: потребовалось
поэтому: поэтому
появиться: появилась, появились
появление: появлением
правительство: правительство, правительством
предложить: предложена, предложили
предназначить: предназначен
предстоять: предстояло
предыдущий: предыдущих
прежний: прежнему
преимущество: преимущества
преодолевать: преодолеваемые
препятствие: препятствия
при: при
прибалтика: прибалтике
признанный: признанные
признать: признан
прийтись: пришлось
применение: применения
применяться: применялись, применялось
принимать: принимали
принятие: принятии
принять: принят, принята, принято
приобрести: приобрести
природопользование: природопользования
приходиться: приходилось
прицельный: прицельным
пробить: пробить
провести: проведена
проводиться: проводились
продвижение: продвижение
продемонстрировать: продемонстрировать
проект: проекту
производиться: производиться
производство: производстве, производство
пройти: прошло
прорыв: прорыва, прорывов
простой: простую
против: против
противник: противника
противоположный: противоположную
противоснарядный: противоснарядную
противотанковый: противотанковая, противотанковые, противотанковых
прохоровский: прохоровской
проявиться: проявились, проявилось
прямо: прямо
путь: пути, путь
пушка: пушек, пушка, пушками, пушки, пушкой, пушку
работа: работа
раз: раза
развивать: развивать
развитие: развитие, развития
разгоняться: разгоняться
раздавить: раздавил
различный: различные
размер: размеры
разработать: разработана
разработка: разработке, разработки
разработчик: разработчики
район: район, района
рапорт: рапорт
расстрелять: расстрелял
рациональный: рациональная
ред: ред
ресурс: ресурс
решающий: решающая
решить: решило
ркк: ркка
роль: роль
романович: романович
российский: российского
россия: россии
руководитель: руководителем, руководитель
рф: рф
ряд: ряд
с: со
салов: салов
самый: самым
свариваться: сваривался
свой: свое, своего, своей, своем, свои, своими
связанный: связанных
связь: связи
сделать: сделать
сергеев: сергеев
серго: серго
серийно: серийно
серия: серии
серьёзно: серьезно
сила: силы
сильный: сильнейшим, сильные
система: системе
скоростной: скоростной
скорость: скорость
слабый: слабое
следующий: следующее, следующие
слово: слова
сложность: сложности
сложный: сложный
смотреть: см
смочь: смогли
снабженческий: снабженческими
снаряд: снаряды
сначала: сначала
снизить: снизили, снизить
снк: снк
соблюдение: соблюдение
собранный: собран
собственный: собственные
совершенствование: совершенствования
совет: совете
советский: советские, советских, советского, советское
современный: современных
сожаление: сожалению
создавать: создавать
создаваться: создается
создание: созданием, созданию, создания
создать: создать
сооружение: сооружений
соответственно: соответственно
соответствие: соответствии
соответствовать: соответствовали
сопровождение: сопровождение
соревнование: соревнования
сост: сост
составлять: составлявшую, составляло
сочетание: сочетание
союз: союза
специальный: специальной, специальный
список: список
справедливо: справедливо
сравнение: сравнению
сражение: сражений
средний: средний
срочно: срочно
ссср: ссср
сталин: сталин, сталина
сталинград: сталинградом
стараться: старались
старооскольский: старооскольский
старый: старый
стать: стала, стали
статья: статье
стена: стены
степень: степени
стефанович: стефановна
стойкость: стойкость
сторона: сторону
стратегический: стратегическую
студент: студент
ступень: ступени
сутки: суток
сухопутный: сухопутных
существенный: существенным
существовать: существуют
считать: считают
считаться: считавшиеся
таблица: таблице, таблицу
такой: таким, таких, такого, такое
тактико: тактико
танк: танк, танка, танках, танки, танков, танком
танкист: танкисты
танковый: танковой, танковых
танкомастер: танкомастер
танкостроение: танкостроение, танкостроения
тезис: тезис
тем: тем
теперь: теперь
техника: техника, техники, техникой
технический: технические, технических
тигр: тигр, тиграм, тиграх
тип: типа
толщина: толщина, толщиной, толщину, толщины
только: только
тонна: тонн
топливо: топливо
тот: того, том
точка: точек
тошева: тошева
тракторный: тракторном
требование: требование, требованиям
ттх: ттх
тут: тут
тыл: тыла
тяжёлый: тяжелого, тяжелые, тяжелый, тяжелых
увеличение: увеличения
увеличить: увеличить
угол: углы, угол
удаваться: удавалось
удаться: удалось
уже: уже
указывать: указывал
укрепить: укрепленного, укрепленных
уложить: уложены
уменьшить: уменьшив, уменьшили
университет: университета
уничтожаться: уничтожались
уничтожение: уничтожение, уничтожением
уничтожить: уничтожил
усиленный: усиленную
усилить: усилить
условие: условия, условиях
успешно: успешно
успешный: успешного
установить: установили
установка: установке
установленный: установленными
уступить: уступили
участвовать: участвовала
участие: участие
учёт: учет
февраль: февраля
федеральный: федеральный
филиал: филиал
филос: филос
финский: финский, финских
фирма: фирмы
форма: форму
фронт: фронт
функция: функции
хайнц: хайнц
халкина: халкин
характеристика: характеристик, характеристики
ход: ходе
ходовой: ходовой
хороший: лучше, лучшими, лучших, лучшую, хорошие, хорошую
хотеться: хотелось
хоттиненский: хоттиненского
цифра: цифры
частность: частности
часть: части
чел: чел
человек: люди
челябинск: челябинске
челябинский: челябинском
чем: чем
через: через
число: числе
чтз: чтз
что: что
широко: широко
шт: шт
щучий: щучий
эволюция: эволюция
экипаж: экипаж
экономика: экономики
эксмо: эксмо
эксплуатация: эксплуатации
электронный: электронный
элемент: элементом
это: это, этого, этом
этот: эта, эти, этой
эшелонировать: эшелонированной
являться: являлись, являлся
япония: японии
