абдулгази: абдулгази
авест: авесте
автор: авторы
аз: аза
азия: азии
айтек: айтеке
акад: акад
академик: академика
активно: активно
актуальный: актуальных
аладин: аладин, аладиным
алматы: алматы
аль: аль
амударья: амударьи, амударья
ан: ан
аналогичный: аналогичные
андриан: андрианов
аннотация: аннотация
античный: античных
антропология: антропологии
арабский: арабских
арало: арала, арале
аральский: аральского, аральское, аральском
аридный: аридных
артезианский: артезианских
артефакт: артефактами, артефактов, артефакты
артюхов: артюховой
арун: аруна
археологический: археологическая, археологические, археологическими, археологических, археологического, археологической, археологическую
археология: археологии, археология
археолого: археолого
архив: архив
архивный: архивной
астана: астана
ата: ата
аул: аула
байпаковый: байпаков, байпакова
балл: баллы
бассейн: бассейна, бассейнах, бассейне
бахтибаев: бахтибаев
без: без
бексеит: бексеитов
би: би
биологический: биологические
бируни: бируни
богатый: богата
более: более
больший: большей
большинство: большинство
большой: большое, большой
бонара: бонара
борофко: борофко
брать: берет
бронза: бронзы
бронзовый: бронзового
буран: буранов
бывший: бывшей
быть: был, была, были, было
вайнберг: вайнберг
валиханов: валиханова
варахш: варахш
введение: введение
ведение: ведения
век: век, века, веке, веков
вестник: вестник
весь: весь, всего, вся
ветер: ветров
видеть: видеть
византийский: византийских
виноградов: виноградов
вклад: вклад
влажный: влажной
вместе: вместе
внести: внесли
вновь: вновь
вносить: вносят
вода: водой, воды
водность: водности
водопой: водопоя
водораздел: водораздела
возможно: возможно
возникновение: возникновения
возобновить: возобновлены
война: войны
восполнить: восполнить
восточный: восточно, восточного, восточное, восточной, восточном
впадать: впадающих
впадение: впадение
вполне: вполне
впоследствии: впоследствии
время: времен, времена, времени, время
вследствие: вследствие
всё: все
второй: второй
вывод: выводу
вып: вып
выпас: выпас
выразительный: выразительным
выявление: выявления
гайдул: гайдулы
географический: географические, географическое
геологический: геологических
геолого: геолого
геоморфологический: геоморфологические
глиняный: глиняной
год: гг, года, годах, годов, году, годы
голоценовый: голоценовые
город: города
государственный: государственной
губа: губ
гуманитарный: гуманитарной
далее: далее
дарья: дарье
датировать: датируемых
даудан: даудану
два: двух
дельта: дельтам, дельте, дельты
денгиз: денгиз
дени: дени
деревянко: деревянко
десятилетие: десятилетия
деятельность: деятельности
дженкинсон: дженкинсон
джента: джент
до: до
доисторический: доисторические
доказательство: доказательства
документация: документация
дореволюционный: дореволюционной
дорога: дороге
достаточно: достаточно
достаточный: достаточное
достигать: достигало
др: др
древнеперсидский: древнеперсидских
древнетюркский: древнетюркских
древний: древнего, древней, древнейших, древние, древний, древним, древних
древность: древности
другой: других, другой
европа: европы
европейский: европейских, европейской
единый: единому
елеу: елеуов
ескертк: ескертк
естественно: естественно
естественный: естественного
железный: железного
животновод: животноводами
жина: жина
зависеть: зависели
зависимость: зависимости
заготовка: заготовок
закаспийский: закаспийского
занимать: занимают
заседание: заседаний
засоление: засоления
засушливый: засушливого
затрагивать: затрагивающих
зафиксировать: зафиксировано
зачастую: зачастую
земледелие: земледелия
земля: земель, земли
значение: значение
значимость: значимости
значимый: значимых
значительный: значительный
зона: зонах
зоологический: зоологического
зрение: зрения
иа: иа
из: из
известие: известия
известно: известно
известный: известными, известных
изд: изд
издание: издание
изменение: изменения
изображение: изображения
изучать: изучаемой
изучение: изучению, изучения
изученность: изученность
изъятие: изъятию
изыскание: изысканий
ил: ил
имангалиев: имангалиева
именно: именно
иметь: имеет, имели, имело
иметься: имеется
имп: имп
имя: имени
институт: института
интенсивный: интенсивного
иранский: иранских
ирригационный: ирригационной
искакова: искакова
использоваться: используются
исследование: исследование, исследовании, исследований, исследования
исследователь: исследователей, исследователи
исследовательский: исследовательского
исследовать: исследованы, исследуемому
историграфия: историграфия
историк: историки
историко: историко
исторический: историческая, исторические, исторических, историческое
история: историей, истории, историю, история
источник: источниках
итема: итем
итина: итина
итог: итоги
ишангали: ишангали
каждый: каждый
казалинский: казалинского
казахский: казахский
казахстан: казахстан, казахстана
казахстанский: казахстанские, казахстанскую
казахстать: казахстано
казна: казну
казсср: казсср
как: как
каллаура: каллаур
каменный: каменного, каменном, каменные, каменных
канва: канва
каракумы: каракумах
картографирование: картографирование
каспий: каспий, каспия
кастанье: кастанье
керамика: керамика
кесить: кесь
киргизский: киргизской
китайский: китайских
климат: климата
климатический: климатической
ключевой: ключевые
км: км
кн: кн
книга: книга, книге
когда: когда
количество: количество
коллекция: коллекция
колодец: колодцев
комиссия: комиссии
комитет: комитета
конец: конце, концу
констатировать: констатировать, констатируют
коркыть: коркыт
который: которого, которое, которые
край: край, края
круглогодичный: круглогодичный
кружка: кружка
ку: ку
культура: культур, культура, культурам, культуры
культурно: культурно
культурный: культурное, культурную, культурные, культурными
кунь: куня
курманияз: курманиязов
куюсайский: куюсайская
кызылорд: кызылорда
кызылординский: кызылординская, кызылординского, кызылординской
кыргызско: кыргызско
лерхий: лерх
летописец: летописцев
лита: лит
литература: литературы
лично: лично
локализация: локализация
локализовать: локализованы
любитель: любителей
маев: маев
максимальный: максимального
малов: малов
маловодный: маловодными
мамиров: мамирова
маргулан: маргулана
маршрутный: маршрутный
массон: массон
масшабный: масшабные
материал: материалов
мгу: мгу
межбарханный: межбарханные
межвуз: межвуз
мезолит: мезолита
мерц: мерц
местность: местности
местный: местными
место: место
местонахождение: местонахождение
метр: метров
мнво: мнво
мнение: мнению
многоводный: многоводны
множество: множество
могильник: могильник
можно: можно
момент: момента
мона: мон
монография: монографии
море: море, моря
мочь: могут
мы: мы, нам, нами
набор: набором
назвать: названном
накопление: накопления
наличие: наличие
нана: нан
наполняться: наполнялись
например: например
наследие: наследие
наука: наук, наука, науке, науку
наунай: науная
научно: научно
научный: научного, научной, научный, научных
находка: находки
начало: начало
начать: начатые
начаться: начались, началось
наш: нашей
неблагоприятный: неблагоприятных
недостаточный: недостаточную
независимость: независимости
некоторый: некоторой
немаловажный: немаловажное
немедленно: немедленно
немой: нем
необходимо: необходимо
необходимый: необходимая
необыкновенный: необыкновенные
неолит: неолит, неолита
неолитический: неолитические
несмотря: несмотря
нижний: нижнего
низовье: низовьях
новосибирск: новосибирск
новый: новейших, новые, новых
ноябрь: ноябре
о: об
оба: обе, обеих
область: области, область
облысый: облысы
обозначать: обозначать
оборот: оборот
образ: образом
обручева: обручева
обследование: обследование
общий: общ
объёмно: объёмно
обьект: обьектов
один: одними
озеро: озера, озеро
окончательный: окончательного
окрестность: окрестностях
окса: окса
оксус: оксусом
оксуса: оксуса
он: он
онгар: онгар
они: им, ими, их, них, они
опираться: опирается
описывать: описывали
опись: опись
определить: определена
определённый: определенную
опубликовать: опубликованы
опыт: опыт
опять: опять
организовать: организованы
оренбург: оренбург
оренбургский: оренбургского, оренбургской
оросительный: оросительные
орошаемый: орошаемого, орошаемые, орошаемых
орошение: орошения
орудие: орудий, орудия
освоение: освоение
основа: основе
основное: основном
основной: основной
особенность: особенности
особо: особо
особый: особое
осуществляться: осуществлялись
от: от
отан: отан
отечественный: отечественные
открыто: открыто
открытый: открытых
отличительный: отличительным
отличный: отличным
отметить: отметим, отметить
отмечать: отмечал
отнести: отнесен
отразить: отражены
отряд: отряд
отчёт: отчет
падать: падал
палеогеографический: палеогеографических
палеолимиологический: палеолимиологические
палеолитический: палеолитические, палеолитических
памятник: памятник, памятника, памятниками, памятниках, памятники, памятников
параграф: параграфах
первичный: первичного
период: период, периодов, периодом, периоды
письменный: письменных
племя: племен
плотник: плотников
плотников: плотниковым
побережье: побережья
поволжье: поволжья
поголовье: поголовье
под: под
подобный: подобная
подъём: подъемом
поездка: поездка
позволить: позволило
позволять: позволяет
поздний: позднего
познавательный: познавательный
половина: половины
положение: положение
получить: полученных
понижение: понижения
попутно: попутно
поселение: поселений
последний: последних
последующий: последующие, последующим
постройка: постройки
посуда: посуды
посёлок: поселка
почти: почти
поэтому: поэтому
правление: правления
предисловыя: предисловые
предмет: предметы
представить: представлена
преемственный: преемственна
прежде: прежде
преимущественно: преимущественно
прекратиться: прекратился
при: при
приаралье: приаралье
приаральский: приаральских, приаральского
приаралья: приаралья
приводить: приводило
прикаспий: прикаспия
принципиально: принципиально
принять: принял
природоведческий: природоведческие
присарыкамышский: присарыкамышской
прислать: пришли
проанализировать: проанализировать
проблема: проблем, проблема, проблемы
провести: проведенных, проведены, провели
проводиться: проводившиеся
программа: программы
проект: проект, проекту
производить: производить
проистекать: проистекающие
противовес: противовес
протокол: протоколы
протяжение: протяжении
процесс: процессы
пткнуть: пткла
работа: работ, работе, работы
развал: развалов
развалины: развалины
разведка: разведке
разведочный: разведочные
развитие: развитие, развития
различный: различную, различных
разрабатывать: разрабатывают
разработка: разработку
район: района
раличный: раличных
рамка: рамках
ран: ран
ранний: раннего
раскопка: раскопкам
располагать: располагает
рассказ: рассказам
рассмотреть: рассмотрено
расти: росла
революция: революции
регион: региона, регионе, региону
результат: результате, результаты
река: рек, реками, реки
рекогносцировка: рекогносцировки
рекогносцировочный: рекогносцировочные
республика: республика, республики
республикасын: республикасыны
решение: решении
рк: рк
роль: роли
российско: российско
рубанов: рубанов
руководство: руководством
руский: руский
русский: русских
ры: ры
ряд: ряд
савельев: савельева
саратов: саратов
сардоб: сардоба
сарыкамыш: сарыкамыш, сарыкамыша
сборник: сборник
сведение: сведений
свзь: свзи
свидетельство: свидетельства
свод: свод, своду
свой: своей, своих
связанный: связанное
священный: священной
север: северу
северный: северного, северном
северо: северо
сегодня: сегодня
сектор: сектора
серикович: серикович
серия: серия
сибирь: сибири
сильный: сильных
система: системы
скважина: скважин
скот: скота
след: следах
следующий: следующим
слово: слова
служить: служат
случайный: случайных
смотреть: смотря
снк: снк
собрать: собрана
собственный: собственные
собщение: собщений
советский: советская, советскими, советской
совместно: совместно
совместный: совместного
содержаться: содержатся
создать: создан
сокращаться: сокращались
солёность: солености
сопраделный: сопраделных
составитель: составители
сотрудник: сотрудник, сотрудники
сочинение: сочинениях
спб: спб
список: список
сплошной: сплошное
среднеазиатский: среднеазиатской
средневековый: средневековой, средневековых
средний: средних
ссср: ссср
ссылаться: ссылаемся
стан: стан
становиться: становились
станционарный: станционарные
стать: ставшие
статья: статье
степень: степени, степень
степной: степных
степь: степи
сток: сток
столетие: столетия
стоянка: стоянки
субъективный: субъективный
суровый: суровые
существенный: существенный
существование: существование, существования
сущность: сущность
сформулировать: сформулированы
сырдарья: сырдарьи, сырдарья
сырьевой: сырьевых
тажекеев: тажекеева
тажекей: тажекеев
таймагамбет: таймагамбетов
таймагамбетов: таймагамбетова
такой: таким
тапа: тапа
тарих: тарихи, тарихы
ташкент: ташкент
тем: тем
тема: темы
территория: территории, территорий, территория
течение: течение
тип: тип
типо: типо
тогда: тогда
тоже: тоже
толстов: толстов
только: только
тот: тот
точка: точки
точнее: точнее
трансформация: трансформацию
труд: труда, трудах, трудов, труды
туркестанский: туркестанский, туркестанского
тхаэ: тхаэ
тыс: тыс
тысячелетие: тысячелетий
увеличение: увеличение
увидеть: увиденные
уже: уже
узбекский: узбекской
узбой: узбой, узбою
узсср: узсср
укрытие: укрытием
университет: университета
упоминание: упоминания
упоминать: упоминали
уровень: уровень, уровня
урон: урона
условие: условия
успех: успехи
установить: установлено
усыхание: усыхания
учёный: ученой, учеными, ученых
учёт: учета
фаза: фазы
факт: факт
фактор: фактор
феномен: феномен
филиал: филиала
фонд: фонд
форма: форма
формоз: формозов
фрагмент: фрагментов
фрагментарность: фрагментарность
фёдоров: федоров
фёдорович: федорович
хан: хана
характеристика: характеристику
хива: хиву
хлопковский: хлопковский
ход: ходе
хозяйство: хозяйства
хорезм: хорезм, хорезма
хорезмский: хорезмских, хорезмской
хорошо: хорошо
хронологический: хронологическая
хх: хх
целенаправленный: целенаправленных
целый: целые
цель: цели, целью
центр: центра
центральный: центральной
цистерна: цистерн
часть: части, частью
человек: человека, человеком
чем: чем
чирикрабатский: чирикрабатской
число: числе, число
член: членов
чраэ: чраэ
что: что
широко: широко
широкомасштабный: широкомасштабные
шорай: шораев
штереть: штер
ызылорд: ызылорда
ыслама: ыслам
эволюция: эволюция
экспедиция: экспедицией, экспедиции
энеолит: энеолит, энеолита
эпизодический: эпизодические
эпох: эпохы
эпоха: эпох, эпохи, эпохой, эпоху
этнографический: этнографические, этнографической
этнография: этнографии, этнография
это: это, этого
этот: эти, этой, этому
южный: южного
явиться: явились
являться: является
язык: языках
яксарт: яксарта
яксарта: яксартой
