август: августе
авиалиния: авиалинии
авианалёт: авианалет
автономность: автономности
адмирал: адмирала
акватория: акваторией
активный: активных
аннотация: аннотация
арена: ареной
арктика: арктика, арктике, арктики, арктику
арктический: арктические, арктический, арктических
архангельск: архангельск
архипелаг: архипелаг, архипелаге
атомный: атомная, атомного, атомной, атомный, атомными
база: базы
базирование: базирования
безопасность: безопасности
безопасный: безопасный
белов: белов
беспосадочный: беспосадочный
благодаря: благодаря
блин: блинов
более: более
больший: большая
большой: большой
борис: борису
буквально: буквально
быстрый: быстрым
быть: был, была, были, было
важность: важность
важный: важнейшей
вайгач: вайгач
валерий: валерий
ванкувер: ванкувер
век: века, веке
великий: великой
вермахт: вермахта
вернуться: вернулось
вестись: велись
весь: всех
вечный: вечную
вилькицкий: вилькицкому
вклад: вклад
вкладывать: вкладывать
владивосток: владивостока
внести: внесли
вновь: вновь
внутренний: внутренние
вода: воду
военный: военная, военно, военные, военных
возглавлять: возглавлял
война: войны
войско: войска
вооружённый: вооруженных
восток: востока
впервые: впервые
врангель: врангеля
время: время
вскоре: вскоре
всплыть: всплыла
всё: все
второй: вторую
вундерланда: вундерланд
вывести: выведен
выполнить: выполнили
высадиться: высадились
высокий: высокие, высокой
выход: выход
где: где
географ: географ
героический: героический
герой: герои
гидрографический: гидрографическую
главсевморпуть: главсевморпуть
год: года, годах, годов, году, годы, лет
государственный: государственный
государство: государство
гражданский: гражданской
граница: границ
громов: громов
груз: грузов
два: два, две
двигатель: двигателями
движение: движения
девять: девяти
действие: действий, действия
декабрь: декабря
день: дня
дмитриевич: дмитриевича
до: до
должный: должно
доставить: доставили
достигнуть: достигла, достигло
дрейф: дрейф
дрейфовать: дрейфующая, дрейфующей, дрейфующих, дрейфующую
евген: евгенов
единственный: единственный
ермак: ермак, ермака, ермаком
есть: есть
жить: живут
забросить: заброшены
забытый: забытые
загрязнение: загрязнение
задача: задаче
запад: запад
заполярье: заполярье, заполярья
заселение: заселение
затем: затем
захват: захватом, захвату
защищать: защищать
здесь: здесь
земля: земли, земля
зимовать: зимовал
зимовщик: зимовщиков
знаменитый: знаменитого
зона: зона
иван: иван, ивана
идея: идее
из: из
изд: изд
изложить: изложена
изучение: изучении, изучения
именно: именно
иметься: имеется
имя: именем
институт: институт
инфраструктура: инфраструктуры
иосиф: иосифа
использование: использование
исследование: исследования
исследователь: исследователи, исследователя
исследовательский: исследовательская, исследовательский
исторический: историческая, исторических
история: истории, история
источник: источник
исход: исходе
июнь: июня
как: как
капитан: капитан, капитану
карский: карское
карта: карту
картографический: картографическую
кафедра: кафедра
километр: километров
класс: класса
ключевой: ключевые
км: км
колонизация: колонизация
командование: командование, командованием
комиссар: комиссаром
комсомол: комсомол
конец: концу
константинович: константинович
континент: континента
конференция: конференции
корабль: корабли, корабля
который: которая, которого, которой, котором, которыми
крайне: крайне
крайний: крайнем
кратко: кратко
крупный: крупнейший
кузнецов: кузнецов
купецкий: купецкий
кучий: кучиев
ледовитый: ледовитого
ледокол: ледокол, ледокола, ледоколами, ледоколах, ледоколы
ледокольный: ледокольного
ленин: ленин
ленинский: ленинский
лечь: легли
лидер: лидером
литература: литературы
лишь: лишь
лодка: лодка
льдина: льдина, льдине
любимый: любимые
лёд: лед, льда, льдами
лётчик: летчики
магистрант: магистрант
май: мая
макаров: макарова
маломощный: маломощный
март: марта
масштабный: масштабное, масштабной
материал: материалов
международный: международной
мемуары: мемуары
месяц: месяцев
миля: миль
министерство: министерству
мир: мире
мировой: мирового, мировой, мировую, мировым
михаил: михаил
многие: многие
многолетний: многолетнего
молодой: молодое
море: море, моря
мореплаватель: мореплаватели, мореплавателя
морской: морские, морским, морских, морского, морской
моряк: моряки
москва: москвы
мощность: мощности, мощностью
мощный: мощнейший, мощного, мощный
мурманск: мурманске
наблюдение: наблюдения
навигация: навигации
надводный: надводное
назвать: названный
называться: называлась
нанести: нанесли
напомнить: напомнить
населить: населенных
наука: науки
научно: научно
научный: научной, научную, научные
начало: начала, начало
начальник: начальник
начаться: началась, начались
наш: нашей, наших
небольшой: небольших
немецкий: немецкие
необходимо: необходимо
несколько: несколько
несмотря: несмотря
ни: ни
новый: новая, нового, новой, новый
ночь: ночь
нужный: нужное
оберегать: оберегать
обеспечение: обеспечении, обеспечению
обеспечивать: обеспечивали
оборонительный: оборонительного
оборонный: оборонный
оборудование: оборудование
объект: объектов, объекты
огромный: огромную
один: одна
однако: однако
ознаменовать: ознаменовало
океан: океан, океана
около: около
окружающий: окружающей
он: он
она: ее
они: них, они
операция: операции, операция
определённый: определенный
организация: организация
организовать: организован
освоение: освоение, освоении, освоения
оседлать: оседлал
осипович: осиповича
основа: основу
основной: основные
основный: основных
особый: особых
остров: острова
ответственность: ответственности
отечественный: отечественного, отечественной
открытие: открытие
открыть: открыл
открыться: открылась
отличаться: отличаются
отношение: отношению
отправиться: отправились
отсутствовать: отсутствует
отто: отто
охрана: охране
очень: очень
папанин: папанина
партия: партии
первый: первая, первого, первой, первую, первые, первый, первым
передать: передан
перелёт: перелет
план: план
платформа: платформа
побывать: побывал
под: под, подо
подводный: подводная
поднять: поднят
подразделение: подразделений
позволить: позволило
показать: показал, показана
покоритель: покорителя
покорить: покорили
полюс: полюс, полюса, полюсе
полярник: полярника
полярный: полярная, полярного, полярную, полярные, полярных
понимать: понимало
поручить: поручено
после: после
последний: последнее
последующий: последующим
поставить: поставлен
постоянный: постоянные
построить: построен, построены
поступить: поступило
потенциал: потенциал, потенциала
потёмкинский: потемкинские
поход: похода
почти: почти
поэтому: поэтому
правительственный: правительственным
предварительный: предварительной
прекрасный: прекрасную
преодолеть: преодолел
применение: применение
примерно: примерно
природа: природе
провал: провал
продлить: продлить
продолжаться: продолжался
продолжиться: продолжилось
продукт: продуктами
произойти: произошло
пройти: пройдя, прошел, прошла, прошли
проработать: проработал
прослужить: прослужил
противник: противника
пункт: пунктов
путь: пути, путь
путём: путем
работа: работы
работать: работала, работать
работоспособность: работоспособность
раз: раз
разведка: разведки
развитие: развития
развёртывание: развертывания
разработать: разработан
распад: распада
располагаться: располагается
расположить: расположена
рассмотреть: рассмотрены
реализовать: реализована
революционный: революционного
регион: регионов
резко: резко
рейх: рейха
риск: риск
роль: роль
российский: российские, российский, российского, российской
россия: россии, россия
руководство: руководство, руководством
русский: русского
рф: рф
сам: самого
самодвижущийся: самодвижущаяся
самойлов: самойлов
самый: самая
сборник: сборник
связать: связана
связь: связь
сгорание: сгорания
севастополь: севастополь
севастопольский: севастопольский
север: севера, севере
северный: северная, северного, северном, северные, северный, северным, северных
севморпуть: севморпути
середина: середине, середины
серьёзный: серьезные
сеть: сетью
сибирь: сибири
сила: сил
силовой: силовых
следом: следом
слово: слова
снизиться: снизилось
собачий: собачьих
событие: событий, события
совершить: совершен, совершили
советский: советские, советский, советское, советской
современный: современными
создание: создание, создании, создания
создать: создал
сократиться: сократилось
сокровищница: сокровищницу
союз: союз
сп: сп
спб: спб
список: список
спустить: спущен
сравнение: сравнению
сразу: сразу
средство: средства
срок: срок
ссср: ссср
станция: станции, станций, станцию, станция
стать: стал, стала, стать
статья: статье
степан: степана
стоить: стоит
столетие: столетий
стоянка: стоянку
стража: страже
страна: страна, страны
страница: страница, страницы
стратегический: стратегический
стратегия: стратегии
строение: строений
студёный: студеные
судно: судно
существенно: существенно
сформировать: сформированная
съёмка: съемку
сыграть: сыграло
таймыр: таймыр
территория: территорий, территориях
течение: течение
тимофеевич: тимофеевича
точка: точка
транспорт: транспорт
требование: требования
третий: третьего
треть: трети, треть
три: трех, три
тысяча: тысяч
углеводород: углеводородов
уже: уже
университет: университет
упряжка: упряжках
установить: установили
установка: установки, установок
участник: участники
фгаоу: фгаоу
февраль: февраля
федерация: федерации
финансирование: финансирование
флаг: флаг, флаги
флот: флота
формирование: формирования
франц: франца
хорошо: хорошо
хх: хх
целое: целом
цель: цели, цель
цивилизация: цивилизации
человек: люди
через: через
честь: честь
чилингаров: чилингаров
число: число
чкалов: чкалов
чтение: чтения
что: что
чудо: чудес
шмидт: шмидт, шмидта
щит: щит
экологичный: экологичны
экспедиция: экспедиции, экспедиций, экспедицию, экспедиция
эксплуатация: эксплуатации
энергетика: энергетики
энергетический: энергетической
этап: этапы
это: это
этот: эта, эти, этими, этой, этот
юлиевич: юльевич
юрий: юрий
являться: является, являются
ядерный: ядерных
японский: японскую
