август: августа
авиакатастрофа: авиакатастрофа
авиационный: авиационный
авторский: авторской
активно: активно
активный: активных
алексушин: алексушин
анализировать: анализирует
аннотация: аннотация
ансамбль: ансамбля
атмосфера: атмосфера
бард: бардами, бардов
барда: барда, барду
бардовский: бардовских, бардовского, бардовской, бардовском
без: без
берег: берегу
благодаря: благодаря
близкий: близких
братство: братство
быстро: быстро
быть: был, были
важность: важности
валерий: валерий, валерия
вблизи: вблизи
вверх: вверх
вдохновитель: вдохновителя
вернуться: вернулся
весь: всей, всех
взаимоуважение: взаимоуважения
вклад: вклад
владимирович: владимирович
влияние: влияние, влияния
вновь: вновь
вода: водах, воде
возраст: возрастов
волжский: волжская
восстановимый: восстановим
впервые: впервые
вписать: вписанным
время: время
всероссийский: всероссийский
всесоюзный: всесоюзном
встреча: встречах
второй: второй
выдающийся: выдающемуся
выйти: вышла
высокий: высокую
выступать: выступал
выступить: выступить
выступление: выступление
гибель: гибель
гитара: гитаре
глеб: глеб
год: года, году, годы, лет
город: городе
городской: городской
государственный: государственный
готовить: готовил
гришин: гришина
грушин: грушин, грушина
грушинок: грушинка
грушинский: грушинский, грушинское
далёкий: дальше
дань: данью
дата: дата
движение: движение, движении, движения
день: день
деятельность: деятельность
дно: дном
доклад: докладов
должный: должны
доц: доц
друг: друзей
другой: других
ежегодно: ежегодно
жизнь: жизни, жизнь
жить: жить
жюри: жюри
запустить: запустить
значимый: значимых
значительный: значительное
играть: играл
идея: идеями
из: из
известно: известно
известный: известны
именно: именно
иметь: имел
имя: имена, имени, имя
институт: институт, институте
интернат: интернат
исполнитель: исполнителей
исполнять: исполняя
исполняться: исполнялись, исполняются
исследовать: исследует
история: истории, историю
истый: ист
кадр: кадров
казанка: казанке
как: как
клуб: клуб, клуба
ключевой: ключевые
коммуна: коммуна
конец: конце, концов
константин: константин
контроль: контроля
конференция: конференции
концерт: концертах
который: которой, которые, который
ксп: ксп
кузница: кузницей
куйбышев: куйбышеве
куйбышевский: куйбышевский
культура: культуру, культуры
культурный: культурная, культурного, культурное, культурных
курс: курса
лауреат: лауреатов
ледяной: ледяной
литература: литературы
лишь: лишь
лодка: лодка, лодке, лодку
люба: люба, любу
любим: любимы
любитель: любителей, любителями
лёня: лёня
материал: материалы
международный: международной
мероприятие: мероприятий
метеостанция: метеостанции
мир: мире
мировой: мировую
михаилович: михайлович
многий: многими, многих
многочисленный: многочисленных
момент: моментом
москва: москве
мотор: мотор
моторный: моторную
музыка: музыкой
музыкальный: музыкальном
музыкант: музыканта, музыкантами
навсегда: навсегда
назад: назад
наслать: нашли
наследие: наследие, наследия
настоящий: настоящей
наука: наук
научно: научно
научный: научный
начальник: начальник
немало: немало
неожиданно: неожиданно
непрерывность: непрерывности
несколько: несколько
несчастливый: несчастливому
новый: новых
ноябрь: ноября
ныне: ныне
обмен: обмена, обмену
оборвать: оборвавшая
обращение: обращения
обстоятельство: обстоятельств, обстоятельства
общение: общения
объединять: объединяет
обычно: обычно
огромный: огромную, огромный
один: одним, одних, одного
однако: однако
ой: ой
оказать: оказал
оказаться: оказалась, оказались
оказывать: оказывать
октябрь: октября
он: его, он
она: нее
они: их
опыт: опытом
организатор: организатора, организаторов
организаторский: организаторские
организовать: организовал
основать: основанная
осознание: осознанию
оставить: оставила, оставить
остаться: остался, останется
отказываться: отказывались
открытость: открытости
открыть: открыты
отправиться: отправился
оценка: оценку
память: памяти
педагогический: педагогический
пение: пением
первый: первый
перевернуть: перевернутой
перевернуться: перевернулось
перегрузить: перегруженное
перепугать: перепуганных
песенный: песенного, песенное
песня: песен, песни, песня
петь: поющие
писать: писал
площадка: площадку
плыть: плыть
поворотный: поворотным
погибнуть: погиб
под: под
позволить: позволили
пока: пока
покидать: покидать
поклонник: поклонников
получить: получил, получило
поплыть: поплыл
популяризация: популяризации
популярный: популярным, популярных
попытка: попытке
послужить: послужил
поступить: поступил
потом: потом
потрясти: потрясло
практический: практической
предоставить: предоставив
представитель: представителей
преемственность: преемственности
прежний: прежнему
при: при
приглашение: приглашение
пригрозить: пригрозил
признак: признаков
пример: примером
принцип: принципах
принять: принял
проводиться: проводится, проводятся
продолжать: продолжает
проза: проза
произойти: произошло
происшествие: происшествие
проф: проф
процесс: процесс
проявляться: проявляться
прыгнуть: прыгнул
публика: публике, публики
пустота: пустоту
развитие: развитие, развития
раздумье: раздумий
разыграться: разыгралась
ранний: ранних
ребёнок: детей, дети
река: реке, реки, реку
родиться: родился
российский: российскую
россия: россии
рост: росту
ру: ру
руководитель: руководитель
руфатович: руфатовна
рф: рф
с: со
сам: сам, саму
самара: самара
самарский: самарский
самодеятельность: самодеятельности
самодеятельный: самодеятельная, самодеятельной
самый: самых
сафин: сафина
свитер: свитер
свой: своего
сегодня: сегодня
сей: сей
село: села
сердце: сердца
середина: середине
серьёзный: серьезным
символ: символом
слово: слов, слова
смерть: смерти, смерть
снять: сняв
собственный: собственные
событие: событие, событий
советский: советская, советского
создать: создать
сообщество: сообщества
состав: составе
сохранение: сохранения
спасти: спасти
список: список
способность: способности
способствовать: способствовал, способствуя
среди: среди
стать: стал, стала, стали, стало
статья: статья
стечение: стечению
стиль: стилей
страна: стране
студент: студент, студентов
студенческий: студенческого
судно: судно
существование: существования
талантливый: талантливого, талантливых
творческий: творческих, творческого, творческому
тезис: тезисы
телевидение: телевидении
толерантность: толерантности
толчок: толчком
только: только
трагедия: трагедией, трагедия
трагический: трагический, трагической
традиционный: традиционным
третьяк: третьяков
уважаемый: уважаемых
увидеть: увидев
увлекаться: увлекался
уговорить: уговорил
уд: уды
удар: ударом
укрепление: укреплению
укрытие: укрытие
умыться: умыться
университет: университет
уникальный: уникального
уплыть: уплыла, уплыть
успех: успех
успешный: успешных
утром: утром
уход: уход
уцепиться: уцепившихся
участвовать: участвовал
участие: участие
участник: участников
учёба: учебы
фестиваль: фестивале, фестивалей, фестиваль, фестивалю, фестиваля, фестивалях
формирование: формированию
хадома: хадома
хадоминский: хадоминской
художественный: художественной
часто: часто
человек: человек
что: что
шивер: шиверы
широкий: широкой
штормовка: штормовку
экономический: экономический
элина: элина
это: это, этого, этом
явление: явления
яркий: ярких
