академик: академика
активн: активным
ан: ан
анастасия: анастасия
аннотация: аннотация
арен: арене
арми: армии
астраханским: астраханским
атаман: атаман, атаманом, атаману
бакалавриат: бакалавриата
балтийск: балтийскому
бахрушин: бахрушин
бгу: бгу
беззаветн: беззаветно
безумн: безумной
безусловн: безусловно
белоруссия: белоруссия
бескорыстн: бескорыстно
бесстрашны: бесстрашные
битв: битва
богатств: богатства
бомбардировал: бомбардировали
боролос: боролось
бремя: бремя
брянск: брянского
был: был, была, были, было
важн: важными
век: века, веками, веке
велик: великому
весен: весенней
вех: вехами
вечн: вечной
взял: взяли
взяти: взятие
взятия: взятия
вклад: вклад
власт: власти
влияни: влияние
влюбленн: влюбленным
внеш: внешней
внутр: внутри
внёсши: внёсшие
военачальник: военачальнику
военн: военных
вожд: вождем
возможност: возможностей
воин: воинов
войск: войска
волг: волге, волги
воля: воля
ворвалис: ворвались
восток: восток, востоке
восточн: восточное
вошл: вошло
времен: времени
время: время
все: всей
всеобщ: всеобщей
встречал: встречали
вступил: вступил
втор: второе, второй, вторым
выделялис: выделялись
выпал: выпала
выход: выход
вячеславовн: вячеславовна
генезис: генезиса
геро: героев
героически: героические
глав: главе
главн: главное, главных
год: год, годом
гомел: гомель
гомельск: гомельского
горел: горела
горны: горные
город: город, города
государ: государь
государств: государств, государства
государствен: государственного
готовност: готовность
границ: границу, границы
гроз: грозного
грозн: грозным
гуманитарн: гуманитарных
давал: давали
даж: даже
дальнейш: дальнейшего, дальнейшему, дальнейших
дан: дань
данн: данной
датированн: датированный
дающе: дающее
действия: действия
делилис: делились
деятел: деятели
дик: дикой
дисциплин: дисциплин
длился: длился
дмитри: дмитрий
дмитрия: дмитрия
доблест: доблесть
доброволь: добровольного
добыч: добычу
долги: долгий
доносил: доносил
достигат: достигать
достич: достичь
достойн: достойны
доц: доц
древним: древними
дремучи: дремучие
его: его
ему: ему
ермак: ермаком, ермаку
жестоки: жестокий
жителям: жителям
завоевани: завоевание, завоеваний
задач: задачей
закончился: закончился
запад: западе
западн: западное
затрат: затраты
захватил: захватили
захватыват: захватывать
защитник: защитников
защищался: защищался
защищат: защищать
звук: звук
земел: земель
земл: земли, землю
землях: землях
знаменит: знаменитому
знан: знаниями
значим: значимым
значимост: значимости
значительн: значительно
золот: золотая
иван: ивана, иваном
иванович: ивановича
игр: игру
из: из
изд: изд
им: им
имел: имели
имен: имени
именн: именно
импульс: импульсу
исследовани: исследование
исследовател: исследователи
ист: ист
истори: истории
историческ: историческом
история: история
кажд: каждом
казак: казаки
казан: казани, казанский, казань
казанск: казанского, казанском
казанским: казанским
казачь: казачьей
как: как
канд: канд
кафедр: кафедра, кафедры
ключевы: ключевые
княжеств: княжества
колонизаци: колонизации
контроля: контроля
котор: которое, который, которых
которы: которые
крепост: крепости
кривенков: кривенкова
крупнейш: крупнейших
крымск: крымского
кульпин: кульпин
культур: культуру, культуры
курс: курса
ландшафт: ландшафтов
легенд: легендам
лет: лет
летописец: летописец
литератур: литературы
лич: личного
макарович: макаровича
мастерств: мастерства
международн: международной
местн: местным
местны: местные
мечт: мечта
миллер: миллер
михайлович: михайлович
мног: много
могл: могли
монгольск: монгольского
мор: морю
москв: москвы
мощн: мощных
мышления: мышления
набег: набеги, набегов
навык: навыками
над: над
называему: называемую
направления: направления
народ: народ, народа
населенн: населенный
наследи: наследие
наук: наук
научн: научный
находившийся: находившийся
национальну: национальную
начал: начала, начало
наш: наша, нашей, нашу
нашл: нашло
невероятн: невероятным
недр: недра
недрах: недрах
некоторы: некоторые
необходим: необходимо
необъятн: необъятной
непреодолим: непреодолимой
непрост: непростых
неудачн: неудачным
неуклонн: неуклонно
нижн: нижнего
нов: новых
новозыбк: новозыбков
новы: новые
нрав: нрав
нынеш: нынешней
област: области
образ: образом
обстоятельствах: обстоятельствах
объединил: объединила
огромны: огромные
одн: одно
одним: одним
оказался: оказался
она: она
они: они
описывается: описывается
ополчилис: ополчились
орд: орда
осад: осады
осажден: осажден
осваив: осваивая
освоени: освоение, освоению
освоения: освоения
основн: основной
основны: основные
оставалис: оставались
от: от
открыв: открывая
открыл: открыло
открылся: открылся
отражают: отражают
отражени: отражение
очерк: очерки
памят: памяти
перв: первый
период: период
петровск: петровского
платит: платить
племен: племена, племенами
пленн: пленных
побед: побед
поволжским: поволжским
поволжья: поволжья
под: под
подарил: подарила
подвиг: подвигов
позволившим: позволившими
познани: познание
показывают: показывают
покорени: покорение, покорении
покорения: покорения
покорител: покорителю
политик: политики
половин: половине
помог: помогая
поселения: поселения
поступк: поступки
поход: похода
правления: правления
превратит: превратить
превращал: превращали
преданност: преданности
предпосылк: предпосылки
предпринят: предпринято
прекратил: прекратило
преодолеват: преодолевать
преодолел: преодолели
привнося: привнося
приврал: приврали
принес: принес
природн: природных
притягивает: притягивает
причин: причины
пробираяс: пробираясь
проблем: проблемы
проводилис: проводились
продвигалис: продвигались
прозван: прозван
произошл: произошло
промышленност: промышленность
проникл: проникли
проникновени: проникновению
просторность: просторностью
просчет: просчетам
против: против
противостоят: противостоять
протяжени: протяжении
процветания: процветания
процветающи: процветающий
процесс: процесс, процесса
прошл: прошла
псрл: псрл
пут: пути, путь
пушек: пушек
пыльны: пыльные
развив: развивая
развития: развития
разнообрази: разнообразием
разорял: разоряли
распутиц: распутицы
расширени: расширению
расширит: расширить
регион: регион, регионе, регионом
результат: результатом
рек: реке
репринт: репринт
республик: республики
ресурс: ресурсов
решающ: решающей
решительност: решительности
решительны: решительные
рискованну: рискованную
родин: родине, родину, родины
росси: россии
российск: российского
россия: россия
руководител: руководитель
руководств: руководством
рус: руси, русский, русских, русское
русск: русского, русской
русски: русские
русским: русскими
рф: рф
сам: самых
самодостаточн: самодостаточными
самостоятельн: самостоятельное
свияг: свияга
сво: свое, своего, своей, своем, свои, своих, свою
своим: своими
себ: себе
себя: себя
сель: сельское
сибир: сибири, сибирь
символ: символами
сквоз: сквозь
скорин: скорины
слов: слова
сложн: сложный
смелост: смелости
смелу: смелую
сняти: снятием
со: со
собственн: собственной
событи: событием
события: события
совершенствуя: совершенствуя
современ: современного
создавал: создавали
сознани: сознании
сознательн: сознательным
сопротивлени: сопротивление
состав: состав
состояния: состояния
социальн: социально
соцэкгиз: соцэкгиз
список: список
способн: способна
сред: средней
средн: среднего
ссср: ссср
ставш: ставшего
стал: стала, стали, стало
становилис: становились
стат: стать
стать: статье
стен: стены
степ: степи
столети: столетий
сторон: стороны
стран: страна, страны
стратегическ: стратегического
студент: студент
сурову: суровую
существовани: существование
сформировалис: сформировались
табор: табора
таинственн: таинственными
тайг: тайги
таким: таким
татар: татар, татаро
татарстан: татарстан
территори: территории
тимофеевич: тимофеевичу
товар: товар
толочк: толочко
толчок: толчок
тольк: только
традици: традиции
требовал: требовали, требовало
три: три
трудност: трудности
тяжел: тяжелое
уважения: уважения
уголок: уголок
удивительн: удивительный
укрепит: укрепить
университет: университета
успех: успехи
успешн: успешными
установлени: установление
участник: участником
фигур: фигурой
филиал: филиал
фирс: фирсое
фундамент: фундаментом
хан: хана
ханств: ханства, ханствами, ханство
хозяйств: хозяйство
храброст: храбрости
худяк: худяков
царств: царстве, царство
царствования: царствования
царя: царя
цел: целей
цель: целью
цеп: цепи
цивилизаци: цивилизации
чест: честь
чтения: чтения
что: что
штурм: штурм
экономик: экономике
экономиче: экономических
эпическим: эпическим
эпох: эпоху
этап: этапами
эти: эти
это: это
этог: этого
этот: этот
эту: эту
юг: юг
юго: юго
южн: южное
является: является
являются: являются
