азбука: азбука
акт: акты
активно: активно
александрович: александрович
аналогичный: аналогичному
аннотация: аннотация
аппарат: аппарата
архив: архива
аспект: аспектах
база: базы
бес: бесами
библиороссик: библиороссика
бич: бич
благодаря: благодаря
богохульный: богохульных
более: более
борьба: борьбы
брать: брал
бунин: бунина
быть: была, были, было, быть
бюрократический: бюрократического
ввиду: ввиду
ведовство: ведовство
ведомство: ведомства, ведомствами
ведьма: ведьм, ведьмами, ведьмы
век: вв, века, веках
вели: вели
величество: величества
вестись: велось
весь: всех
вид: вид, виде
видеть: видеть
видно: видно
внимание: внимание, внимания
внутри: внутри
возможность: возможность
возраст: возрасте
вопрос: вопроса, вопросу, вопросы
вплоть: вплоть
время: времени, время
вроде: вроде
вряд: вряд
всеволод: всеволод
всегда: всегда
встречаться: встречается
всё: все
выдержка: выдержки
вынесение: вынесении
выноситься: выносилось, выносился
вытекать: вытекает
выше: выше
выявление: выявления
выяснить: выяснить
гадание: гадание
георгиевич: георгиевич
главный: главной
год: гг
горелов: горелов
город: городах
государев: государевы
государственный: государственного, государственный
государство: государств, государства
граница: границы
гримуаровый: гримуаров
группа: групп
даже: даже
дальнейший: дальнейшего
данный: данного
дать: данной, данные
движение: движениями
действовать: действовавшего
дело: дел, дела, делам, делами, дело, делу
делопроизводитель: делопроизводителей
демон: демонами, демонах
денис: денис
детально: детально
деяние: деяниях
дифференцирование: дифференцирование
до: до
добавиться: добавился
дознаватель: дознавателей, дознаватели
дознание: дознания
дойти: дошел
документ: документов
документальный: документальный
документирование: документирование
допрос: допросов
доступный: доступной
доц: доц
древлехранилище: древлехранилище
древний: древняя
дьявол: дьяволом
европа: европе, европы
единый: единого, единый
елец: елец
елецкий: елецкий
еретический: еретическими
жанр: жанра
живописный: живописных
животное: животными
житель: жителей
заговор: заговоров, заговором
задействовать: задействована
заимствование: заимствования
заимствовать: заимствованные
заключаться: заключается
закон: законов
законодательный: законодательные
законодательство: законодательства, законодательство
заметить: заметить
занимать: занимало
заниматься: занималось, занимался
запад: западе
западноевропейский: западноевропейских, западноевропейской
записка: записок
заподозрить: заподозренными
зачастую: зачастую
здесь: здесь
зелье: зелий
знакомый: знакомых
знать: знаем
значение: значение
из: из
изба: избы
издательство: издательство
изучение: изучении, изучения
изъять: изъятых
именно: именно
иметь: имел, имела, имели, имело
императорский: императорского
империя: империи
иначе: иначе
инстанция: инстанции, инстанциях
интерес: интерес
информация: информации, информация
использование: использованию
использоваться: использовались
исследование: исследований, исследования
историк: историка
историко: историко
исторический: исторический, исторического
история: истории
источник: источник, источника, источников
источниковедческий: источниковедческой
истый: ист
казаться: казалось
как: как
каков: каковы
какой: какие, какое, какой
канторович: канторович
канцелярия: канцелярии
касаться: касается
католический: католической
католическо: католическо
кафедра: кафедра
качество: качестве
кивельсон: кивельсон
классика: классика
ключевой: ключевые
когда: когда
колдовской: колдовским, колдовских, колдовской
колдовство: колдовства, колдовстве, колдовство, колдовству
колдун: колдуна
коллегия: коллегий
коллман: коллман
компаративный: компаративные, компаративных
конец: конца, конце
контакт: контактах
контекст: контексте
концентрация: концентрацию
концептуальный: концептуальном
концепция: концепции, концепцию
королева: королев
который: которая, которое, которые, которых
культура: культуре
культурно: культурно
культурный: культурного, культурные, культурный, культурных
лавров: лавров
лежать: лежащие
ленанда: ленанд
литература: литературе, литературы
литературный: литературное
лишить: лишены
лишь: лишь
ляпин: ляпин
магический: магические, магических, магического
магия: магии, магия
майер: майер
масса: массу
материал: материал, материалам, материалов, материалы
материальный: материальном
медиевистика: медиевистики
мемуарный: мемуарного
менее: менее
мероприятие: мероприятий
месса: мессах
место: место
метод: методом
можно: можно
молотый: молот
момент: момент
монография: монография
моральный: моральная
московский: московских, московского
мочь: можем
мы: мы, нам, нас
мысль: мысль
над: над
наиболее: наиболее
найти: найти
наказание: наказание
накладывать: накладывала
написание: написанию
направление: направлению
направляться: направлялось
например: например
наследие: наследия
наука: наук
научный: научный
начать: начал
некоторый: некоторые, некоторых
непосредственный: непосредственных
несомненно: несомненно
ни: ни
никакой: никакого
новомбергский: новомбергский
новоуказный: новоуказных
новый: нового, новое
норма: нормы
ношение: ношению, ношения
обвинять: обвиняемых
область: области
обнаружить: обнаружены
обозрение: обозрение
образ: образа, образом
обратиться: обратиться
обращаться: обращалось
обращение: обращением, обращения
общественный: общественном
обычный: обычным
оговор: оговоров
огульный: огульных
одержимость: одержимость
один: одной
однако: однако
оказание: оказания
он: его
они: им, их, ним, ними, них, они
опираться: опирались
описание: описаний
описать: описанный
орган: орган, органов
организация: организации
оргический: оргических
ортодоксальный: ортодоксальной, ортодоксальному
орудие: орудия
освещение: освещение
основа: основе
основное: основном
особенность: особенность
от: от
отделение: отделения
отечественный: отечественной
отладить: отлажено
отличие: отличие
отношение: отношении, отношения
отсутствие: отсутствии
отчаяние: отчаяния
отчёт: отчеты
охота: охота
очевидный: очевидно
памятник: памятники
первостепенный: первостепенным
первый: первое
период: периода
периодически: периодически
перспектива: перспективы
петровский: петровских
печатня: печатня
подверженный: подверженных
подниматься: поднималась
подобный: подобного
подозревать: подозреваемого
подробность: подробности
подробный: подробные, подробных
подряд: подряд
подход: подход, подхода, подходах, подходе
позволять: позволяет, позволяют
поздний: позднее
позиция: позиций
поиск: поиска
показание: показания
поле: поле
полный: полное, полном
помощь: помощью
попадать: попадала
поправка: поправками
портрет: портрета
посвятить: посвящена
поскольку: поскольку
после: после
последний: последней
посольский: посольского
потенциальный: потенциальный
почерпнуть: почерпнуть
появляться: появляется, появлялись
правление: правление
право: права
правовой: правовом
православный: православная
практика: практике, практики
практически: практически
практический: практическим
предмет: предмет, предметом
предполагать: предполагал
представить: представлен
представление: представление
представлять: представляют
преображенский: преображенский, преображенского
преступление: преступление, преступлений, преступления
при: при
привести: приведенных
привлечение: привлечения
приговор: приговор
приготовление: приготовление
признание: признаний
приказ: приказ, приказа, приказе
приказный: приказной, приказные
применение: применения
принадлежность: принадлежности, принадлежность
приобщаться: приобщался
пристальный: пристального
проблема: проблемы
проведение: проведения
проводить: проводить
проникать: проникала
проникнуть: проникли
прорабатывать: прорабатывала
проследить: проследить
просопографический: просопографических
просуществовать: просуществовавшей
протестантский: протестантской
протокол: протоколах, протоколов, протоколы
профессиональный: профессиональной
процесс: процессе, процессы
прочее: прочего
прошедшее: прошедших
прямой: прямого
пытка: пыток
пётр: петр, петра, петром
работа: работа, работе, работы
развиваться: развивалась
различный: различной, различные, различных
разница: разница, разницу, разницы
разнообразие: разнообразия
разнообразный: разнообразном, разнообразные, разнообразных
ранее: ранее
ранний: раннего
расследование: расследование, расследованием, расследованию, расследования, расследованиями
рассматривать: рассматривали
рассматриваться: рассматриваются
расспрос: расспросов
растение: растений
регулярный: регулярной
результат: результатах, результатом
религиозный: религиозной
религия: религия
реформа: реформ, реформу
решение: решение, решений
риск: риску
роль: роль
российский: российская, российской
россия: россии
руководитель: руководитель
руководство: руководств
русский: русские, русского, русское
русь: русь
рф: рф
с: со
сам: само, самой, самом
сведение: сведения
сводиться: сводилась
свой: свое, свою
связанный: связанный, связанных
связь: связи
себя: себе, себя, собой
сегодня: сегодня
сила: силу
система: системы
сказать: сказано
скрупулёзный: скрупулезного
следователь: следователей, следователи
следственный: следственные, следственными, следственных
следствие: следствий, следствия
слово: слова, слово
случай: случаях
слушание: слушания
соборный: соборного
собрание: собрание
собственно: собственно
собственный: собственной
совершение: совершения
содержание: содержание
содержательный: содержательный
содержать: содержат
создавать: создавая
создание: создание
сознание: сознании
составить: составить
составление: составления
составлять: составляют
составляться: составлялись, составлялось
социальный: социального, социальной, социальном, социальных
сочинение: сочинение, сочинения
спб: спб
сперанский: сперанский
специализировать: специализированной
специфика: специфике, специфики, специфику
специфичный: специфичный
списать: списать
список: список
сравнивать: сравнивая
сразу: сразу
среди: среди
средневековый: средневековые
сталкиваться: сталкиваемся
стараться: старались
стать: стало, статей
статья: статье, статьи
столетие: столетия
страница: страницах
стрелецкий: стрелецкий
студент: студент
судебный: судебного, судебный
судья: судьи
существовать: существовало
таки: таки
такой: таким, такими, таких, такого, такой
там: там
текст: текст
тем: тем
тема: тема, теме, темой, темы
тематика: тематикой
теософский: теософская, теософских, теософской
теперь: теперь
тетрадь: тетрадей, тетради
типография: типография
тогда: тогда
тоже: тоже
томск: томск
тот: теми, тех, том, тому, тот
трактат: трактатах, трактатов
требовать: требовали
треть: трети
тщательно: тщательно
увидеть: увидеть, увидим
уделять: уделяла
уезд: уездов
уже: уже
уложение: уложения
университет: университет
упоминание: упоминания
управление: управления
уровень: уровне
усреднить: усредненного
устояться: устоявшегося
участие: участии
учреждение: учреждение
ущерб: ущербе
факт: факт
фактор: фактор
феномен: феномен, феномена
фигурант: фигурантов
фиксация: фиксации
фиксировать: фиксируя
форма: форм
формирование: формирование, формирования
ход: ходе
христианство: христианства
хроника: хроники
царство: царства
цель: целью, целях
ценный: ценнейший, ценный
центр: центре
центральный: центральных
церковь: церкви
чара: чар
чародей: чародея
часто: часто
человек: людьми
что: чего, что
шабаш: шабашах
шамин: шамин
шатковы: шатков
экономика: экономика
эпистолярный: эпистолярного
эпоха: эпох
это: этим, это, этого, этом
этот: эта, эти, этой, эту
эффект: эффекта
юрайт: юрайт
явление: явления
являться: является
яковлев: яковлева
