авдеев: авдеева
автодорог: автодороги
адрес: адрес
азбук: азбука
акт: акты
активн: активно, активное, активными
активну: активную
актуальност: актуальность
акцентирует: акцентирует
александрович: александровичем
александровн: александровна
алибегашвил: алибегашвили
аналог: аналог
анатоли: анатолием
андрея: андрея
аннотация: аннотация
аномали: аномалии
архангел: архангела
архитектор: архитекторов
архитектур: архитектуре, архитектурного, архитектуры
архитектурн: архитектурное, архитектурной, архитектурный, архитектурным, архитектурных
архитектурны: архитектурные
аспект: аспекте, аспекты
аутентичн: аутентичное
аутентичност: аутентичности
афонск: афонского
бабров: бабровы
баз: базе
безопасн: безопасной
белгород: белгород, белгородская, белгородский
белгородским: белгородским
бережн: бережное
биографи: биографии
благодаря: благодаря
близк: близка
близост: близость
бобров: бобровых
богатств: богатстве
бож: божией
боле: более
больш: большая
боролся: боролся
будет: будет
будущ: будущем, будущих
будущим: будущим
был: был, были, было
быт: быть
бюст: бюст, бюста
важн: важно, важной, важными
важност: важности, важность
важну: важную
важны: важные
вдов: вдове
вдохновляет: вдохновляет
вдохновляют: вдохновляют
вдохновляя: вдохновляя
вед: ведь
ведущ: ведущей
век: веков
велик: великой
версия: версия
верующ: верующих
вест: вести
ветеран: ветеранов
вечн: вечной
взаимодействи: взаимодействие, взаимодействию
визуальны: визуальные
вклад: вклад, вкладе, вкладу
включает: включает
власт: власти
влияет: влияет
влияни: влияние
влияния: влияния
внесл: внесли
внимани: внимание
военн: военных
возведенн: возведенный
воздействи: воздействие
воздействуют: воздействуют
возможност: возможность
возникл: возникла
возраст: возрастов
войн: войны
вопрос: вопросов
воспитани: воспитании
воспитатель: воспитательного
воспитыват: воспитывать
воспринял: восприняло
восстановлени: восстановлению
вписывающийся: вписывающийся
времен: времени
время: время
времён: времён
все: все
всеобъемлющи: всеобъемлющие
всех: всех
встреч: встречи
выдающихся: выдающихся
выделяется: выделяется
выживани: выживание
вызов: вызовами, вызовы
выполнен: выполнено
выполнял: выполняла
выражени: выражение
выразит: выразить
выразительн: выразительным
выразительность: выразительностью
выступает: выступает
выступил: выступила
выступлен: выступлениями
выходит: выходит
вышл: вышли
гармоничн: гармоничный
где: где
геологи: геологии
геологически: геологические
геологическу: геологическую
глав: главу
главн: главной, главных
глобализаци: глобализации
глубж: глубже
глубок: глубоком
год: годов, году, годы
горн: горных
город: город, города
городск: городской
горожан: горожан
государственн: государственный
градостроительств: градостроительстве
граждан: граждан, гражданское
губкин: губкин, губкина, губкине, губкинская, губкинский, губкину
губкинск: губкинского
даж: даже
дальнейш: дальнейшему
данн: данное, данной
дань: данью
два: два
дво: двоих
дворах: дворах
двух: двух
действительност: действительность
декор: декором
дел: делу
делает: делает
демонстрируют: демонстрируют
ден: день
дет: детей
дзен: дзен
диан: диана
дни: дни
до: до
должн: должна
должност: должности
дополнительны: дополнительные
дореволюционн: дореволюционный
достижени: достижений
достижения: достижения
достижениям: достижениям
достопримечательност: достопримечательностей
доступ: доступа
доход: доходов
дух: дух, духа
духовн: духовной, духовным, духовных
духовны: духовные
его: его
единственн: единственным
ее: ее
елен: елена
емельян: емельянов
епархия: епархия
ефим: ефимом
желающ: желающих
жен: женских
женск: женского
женщин: женщин, женщины
жертв: жертв, жертвы
жив: живым
жизн: жизни, жизнь
жизненну: жизненную
жител: жителей, жители, жителями
жительниц: жительница
жителям: жителям
забот: заботе
забывают: забывают
загл: загл
задач: задачами
задуматься: задуматься
закрывался: закрывался
заметн: заметный
записн: записной
заслуживает: заслуживает
здани: здание
значени: значение
значения: значения
значим: значимым, значимых
значимост: значимости, значимость
значительн: значительное
зрения: зрения
иван: ивану
ивер: иверская
играл: играли
играют: играют
идентичност: идентичностей, идентичности, идентичность
идет: идет
идея: идея
из: из
избежат: избежать
известн: известна, известная
изменения: изменения
изначальн: изначально
изображающ: изображающего
изучени: изучение
изучения: изучения
икон: икона
имен: именем
именн: именно
имя: имя
индустри: индустрии
индустриальн: индустриальный
инициатив: инициатив
интерес: интерес, интереса
интересен: интересен
исключени: исключением
использовани: использование
использоват: использовать
используется: используется
испытания: испытания
исследовател: исследователей
исследователь: исследовательский
истори: истории, историю
историк: историко
историче: историческая, исторических, историческое
историческ: исторически, исторического, исторической, историческому
исторически: исторические
история: история
источник: источники
исход: исходов
их: их
кажд: каждому
как: как, какой
карандаш: карандашом
катализатор: катализатором
кирпичн: кирпичная
классическ: классическом
ключевы: ключевые
книжк: книжкой
когд: когда
композиция: композиция
компонент: компоненты
контекст: контекст, контексте
контур: контур
конфликт: конфликтов
конц: конца, конце
коротк: короткой
котор: которая, которое, который, которым, которых
котору: которую
которы: которые
крестьянску: крестьянскую
кто: кто
культур: культурного, культуру, культуры
культурн: культурное, культурной, культурном, культурный, культурных
культурны: культурные
курс: курса
курск: курской
ландшафт: ландшафт, ландшафта
ленин: ленина
ленинск: ленинском
лет: лет
литератур: литературы
лицах: лицах
личн: личное
личност: личностей
личностях: личностях
лучш: лучше
люб: любого
люд: людей
магистрант: магистрант
магнитн: магнитной
мария: мария
мат: мать
матер: матерей, матери
материал: материалы
материальны: материальные
мед: меди
межд: между
мемориал: мемориал
мене: менее
мероприяти: мероприятий
мероприятия: мероприятия
мероприятиях: мероприятиях
мест: мест, места, местного, место, местом
местн: местное, местными, местных
металл: металле
мещанин: мещанином
мировоззрени: мировоззрение
мисси: миссию
митинг: митинги
михаил: михаила
михайлов: михайловский
мног: многих
многи: многие
многим: многим
многогранну: многогранную
многослойн: многослойный
множеств: множества, множество
можн: можно
молитв: молитвы
молодеж: молодежи, молодежь
молодёж: молодёжи
момент: момент, момента
монастыря: монастыря
монумент: монумент, монумента
москв: москве
муж: мужа
мужеств: мужество
мысл: мысль
нагрузк: нагрузку
над: над
надежд: надежды
надежн: надежной
надлежащу: надлежащую
накладывает: накладывает
наличи: наличие
напоминани: напоминание, напоминанием
направленны: направленные
напряму: напрямую
народ: народу
народны: народные
нарративах: нарративах
населен: населенного
населения: населения
населённ: населённое
наследи: наследие, наследии, наследию
наследия: наследия
настоятел: настоятелем
настояще: настоящее
настоящим: настоящим
насыщенн: насыщенной
наук: науке, науки, науку
научн: научным
национальн: национальная, национальной, национальный
невидим: невидимыми
недр: недра
немаловажн: немаловажным
необходим: необходимо
неотъемлем: неотъемлемой
непосредственн: непосредственном
несломленн: несломленно
несмотря: несмотря
нефтегазов: нефтегазовой
нефтян: нефтяной
нефтяну: нефтяную
никандр: никандр
николаевн: николаевна
ним: ними
нов: нового, новых
новы: новые
норм: норм
носит: носит
нравственн: нравственных
нужд: нужд
об: об
обеспечит: обеспечить
област: области
облик: облик
образ: образа, образом
образовани: образовании
образования: образования
образовательн: образовательная, образовательном
образовательны: образовательные
образц: образцом
обсуждения: обсуждения
обусловлен: обусловлена
обществ: общества, обществу
общественн: общественных
общественны: общественные
общин: общиной, общины
объединяя: объединяя
объект: объект, объекта, объектами, объектов, объектом, объекты
обыденну: обыденную
одн: одна
одновременн: одновременно
одноимённ: одноимённым
оказавши: оказавшие
оказал: оказал
окол: около
околиц: околицей
окружающи: окружающий
окружени: окружении
олицетворени: олицетворение
олицетворяет: олицетворяет
олицетворяют: олицетворяют
он: он
она: она
они: они
онф: онф
описывается: описывается
определяя: определяя
осколец: осколец
основ: основой
основани: основании
основания: основания
основанн: основанный
основн: основное
основываяс: основываясь
особ: особое
особенност: особенности
осознат: осознать
оставался: оставался
остаются: остаются
отвеч: отвечая
отдельн: отдельных
отечественн: отечественной
открыт: открыт, открытая, открытый
открыти: открытие
открытия: открытия
отметит: отметить
отмечающи: отмечающий
отношени: отношение
отражает: отражает
отражается: отражается
отражают: отражают
отражающим: отражающими
официальн: официальный
оформлени: оформление
очеред: очередь
паломничеств: паломничество
памят: памяти, память
памятн: памятных
памятник: памятник, памятника, памятниками, памятники, памятников, памятником, памятнику
патриотически: патриотические
перв: первый, первым
передават: передавать
передает: передает
передается: передается
передаются: передаются
перенесен: перенесен
пересекаются: пересекаются
период: период
персонификаци: персонификации
пласт: пласт
площад: площади
площадк: площадками
побед: победу, победы
повседневн: повседневной
повторения: повторения
погибш: погибших
под: под
подведут: подведут
подвергаются: подвергаются
подвиг: подвигов
поддержани: поддержании, поддержанию
подлинн: подлинной
подобн: подобных
подростк: подростков
подчеркив: подчеркивая
подчеркивает: подчеркивает
подчеркивал: подчеркивало
позволяет: позволяет
позж: позже
позици: позицию
поколен: поколениями
поколени: поколение, поколений
поколения: поколения
поколениям: поколениям
получает: получает
получают: получают
поминальны: поминальные
понимани: понимание
понимания: понимания
понятн: понятна
посвященн: посвященным
посещает: посещает
посещается: посещается
посещени: посещение
последн: последних
последств: последствиями
постоян: постоянного
постоянн: постоянной, постоянным
пострадал: пострадал
построен: построен
потерявш: потерявших
потерявшу: потерявшую
потерял: потеряла
потребность: потребностью
похоронен: похоронен
почт: почти
почтит: почтить
появилас: появилась
праздник: праздники, праздников
практиче: практическое
преданност: преданности, преданность
предел: пределы
предк: предков
представител: представителей
представляет: представляет
представляют: представляют
преумножит: преумножить
при: при
привезенн: привезенная
привлекает: привлекает
привлекал: привлекал
привлекательност: привлекательность
привлекают: привлекают
привязанност: привязанности
принёс: принёс
природ: природного
приход: приходская
приходит: приходит
приходск: приходской
прихожан: прихожан
пришлос: пришлось
проведения: проведения
проводимы: проводимые
программ: программы
продолжает: продолжает
проект: проектов, проекты
пройден: пройденного
промышленност: промышленность
прост: просто, простого
простот: простотой
протоиерея: протоиерея
прототип: прототипом
протяжени: протяжении
проходят: проходят
процветающ: процветающего
процесс: процесса, процессов, процессы
прошл: прошлое, прошлом
проявлялас: проявлялась
пункт: пункта
пут: пути
работ: работе, работы
работал: работала
рабочи: рабочие
рад: ради
развивался: развивался
развивающееся: развивающееся
развити: развитие, развитии, развитию
развития: развития
различн: различных
размышления: размышления
разн: разных
разнообразн: разнообразное
разны: разные
разрушения: разрушения
район: район, района, районом
рамк: рамки
рамках: рамках
ранен: ранениями
расположенн: расположенный
рассматриваются: рассматриваются
рассмотрен: рассмотрен
реальну: реальную
регион: региона, регионе
регулярны: регулярные
режим: режим
религиоз: религиозного
религиозн: религиозных
религиозны: религиозные
реставраци: реставрации
реставрация: реставрация
ресурс: ресурс, ресурсов
реч: речь
риск: риску
род: родного
рол: роли, роль
росси: россии
россий: российская, российских
рук: руки
руках: руках
руководств: руководством
рус: русский
русску: русскую
рф: рф
сайт: сайт
сам: самого
сведения: сведения
свидетел: свидетелями
свидетельств: свидетельства, свидетельство, свидетельством
свидетельствует: свидетельствует
сво: свое, своего, своей, своему, своих, свою
свободн: свободный
своим: своим
связ: связи
связан: связано
связанн: связанными
свят: свято
святы: святыней
священник: священник
сделан: сделана
себ: себе
себя: себя
сей: сей
сел: села, селе
сем: семей
семейств: семейства
семендяев: семендяевым
семь: семью
сил: силу, силы
сильн: сильное, сильных
символ: символ, символами, символом, символы
символизировал: символизировал
символизирует: символизирует
символизирующ: символизирующих
скромн: скромным
скульптор: скульптором
скульптур: скульптура, скульптуру
скульптурн: скульптурная
следующим: следующим
сло: слоев
слов: слова
служат: служат
служб: службы
служени: служение
служил: служил
служит: служит, служить
смог: смог
соб: собой
собран: собраны
собрани: собраний
собрания: собрания
событи: событий
событиях: событиях
совет: совета
советск: советской
советски: советские
современ: современного
современн: современному, современными
современны: современные
содержат: содержат
соединяется: соединяется
создает: создает
создани: созданию
создания: создания
создат: создать
создаются: создаются
созерцания: созерцания
созидания: созидания
солдат: солдата
сообществ: сообщества, сообщество, сообществу
сооружени: сооружений
соприкасаяс: соприкасаясь
сопровождалос: сопровождалось
составляющ: составляющей
состояния: состояния
сохранени: сохранение, сохранении, сохранению
сохранения: сохранения
сохраняет: сохраняет
сохранялос: сохранялось
сохранят: сохранять
социальн: социальная, социально, социальной, социальных
социальну: социальную
список: список
сплочени: сплочению
сплоченност: сплоченности
способствовал: способствовало
способствует: способствует
способствуют: способствуют
способствующ: способствующих
сред: среди
средств: средство
стал: стал, стали, стало
сталкивается: сталкивается
становится: становится
становлени: становлении
становятся: становятся
стать: статье
стил: стиле
стойкост: стойкость
столети: столетий
стоящ: стоящая
стран: страны
стратеги: стратегий
страх: страха
стремитель: стремительного
стремящихся: стремящихся
строительств: строительства
структур: структуре
судьб: судьбу
сфер: сферы
счет: счет
сынов: сыновей
так: таких, такое
таки: такие
таким: таким, такими
тарапанов: тарапанова
тем: тем, теме, теми, темы
территори: территории
территориальн: территориальный
тех: тех
технологи: технологии, технологий
типичну: типичную
тольк: только
том: том
тоск: тоски
тот: тот
точк: точки
трагеди: трагедии
традици: традиции, традиций
традиционн: традиционно
требуют: требуют
тревог: тревоги
три: три
трудны: трудные
туризм: туризм
турист: туристов
туристическу: туристическую
тяжёлы: тяжёлые
уважат: уважать
уважени: уважение, уважении
уважения: уважения
увековечивани: увековечиванию
увековечивания: увековечивания
увеличени: увеличению
удачн: удачно
уделяется: уделяется
узнат: узнать
укреплени: укреплению
укрепляют: укрепляют
укрепляющ: укрепляющих
улиц: улицу
университет: университет
уникальн: уникальный
условия: условия
условиях: условиях
услуг: услуг
установлен: установлен
установленн: установленных
устраиваются: устраиваются
утрат: утрату, утраты
участи: участие, участии
участник: участниками
уче: ученого
учен: ученому, ученых
учится: учится
учитыв: учитывая
ушедш: ушедших
факт: факт
федоровн: федоровна
фигур: фигура, фигуры
формировавш: формировавших
формировани: формировании
формирует: формирует
формируют: формируют
формирующ: формирующих
формируя: формируя
фронт: фронте
функци: функции
функционироват: функционировать
характер: характер
хозяйств: хозяйство
хорхордин: хорхордина
храм: храм, храма, храме
хрупкост: хрупкость
целы: целые
ценит: ценить
ценност: ценностей, ценности
центр: центр, центром
централ: централного
центральн: центральная
церков: церковь
церковн: церковно
част: часто
часть: частью
чег: чего
чем: чем, чему
через: через
что: что
широки: широкие
шишков: шишковым
школ: школа
школь: школьного
шорстов: шорстово
экономик: экономику
экономическ: экономическом
экран: экрана
электронн: электронная, электронный
элемент: элемента
эмоциональну: эмоциональную
энциклопедия: энциклопедия
эпохах: эпохах
эта: эта
эти: эти
этиче: этических
это: это, этой
этом: этом
этот: этот
эффективн: эффективной, эффективных
является: является
являются: являются
