абазин: абазинами, абазины
август: августа
автор: авторов
агеев: агеева
адил: адиль
адыг: адыгами, адыгское
азербайджанск: азербайджанского
азов: азов, азово, азовский
ак: ак
активн: активно
александр: александр
александровн: александровна
али: али
алибиевич: алибиевич
алиев: алиевой
аннотация: аннотация
анчабадз: анчабадзе
арми: армии
армия: армия
арсланбек: арсланбек
астрахан: астраханский
атаковал: атаковали
бак: баку
без: без
беззакони: беззаконие
белы: белые
берег: берегам
берут: берут
беспощадн: беспощадно
битв: битва, битве
близост: близости
бои: бои
бой: бой
боле: более
болезн: болезни
больш: больше, большей, больших
борьб: борьба
боям: боями
брать: братьями
буг: бугом
будет: будет
буджак: буджакская
бутырск: бутырского
бутырц: бутырцам
бывш: бывших
был: был, была, были, было
былу: былую
быт: быть
важн: важная, важный
важну: важную
вам: вам
вв: вв
вед: ведь
век: века, веке
вернулся: вернулся
верховья: верховья
верховьях: верховьях
вес: весь
взаимоотношени: взаимоотношений
взаимоотношения: взаимоотношения
взят: взять
включ: включая
владимирск: владимирского
внезапн: внезапно
внимани: внимание
внимания: внимания
военн: военное
военну: военную
воин: воинов, воины
воински: воинские
воинствен: воинственного
войн: войне, войны
войск: войска, войскам, войско
волков: волкова
вопрос: вопросу
восем: восемь
восставши: восставшие
восстани: восстание, восстанию
восстания: восстания
восточ: восточного
восточн: восточный, восточных
впервы: впервые
времен: времен
время: время
все: все
всем: всему
всеобщ: всеобщая
встретилис: встретились
всю: всю
всяческ: всячески
всё: всё
втор: второй
входил: входили
вхождени: вхождение
вы: вы
выводит: выводит
выдат: выдать
вышел: вышел
вёрст: вёрст
гарнизон: гарнизоны
где: где
генерал: генерал
геноцид: геноцид
геополитически: геополитические
гир: гирей
глубок: глубоких
глубоким: глубоким
говорил: говорили
говорит: говорит
говорят: говорят
год: года, году
голод: голод
горл: горлом
город: город
городок: городок
государств: государства
государствен: государственного
государственн: государственное
грек: греками
грозн: грозная
губернатор: губернатор
дагестан: дагестана
дал: дали
даниял: даниял
действуя: действуя
декабря: декабря
десятк: десятки
дет: детей, дети
деятел: деятели
диссертаци: диссертации
длилис: длились
днепр: днепром
дни: дни
до: до
добейт: добейте
добыч: добычу
договор: договор, договору, договоры
доктор: доктора
дон: дона, дону
досталис: достались
достигнуты: достигнутые
достойн: достойна, достойно
дошл: дошли
другим: другим
дуа: дуа
дун: дуная
едисан: едисан, едисанская, едисанских
едичкуль: едичкульская
едишкульц: едишкульцев, едишкульцы
еды: еды
ее: ее
еи: еи
ейски: ейский
екатерин: екатерины
емболук: емболуки, емболуков, емболукская, емболукских
ещё: ещё
жалел: жалели
жанеевц: жанеевцев
ждут: ждут
женщин: женщин, женщины
жив: живой, живых
жидков: жидкова
жил: жили, жило
жител: жителей
забыт: забыть
заведующ: заведующей
завершился: завершился
завоевания: завоевания
завоеват: завоевать
завязался: завязался
закончилос: закончилось
закубань: закубанью
зан: зан
занимал: занимали
западноевропей: западноевропейских
запис: записей
заселен: заселена
засыпан: засыпаны
затрагивает: затрагивает
защищал: защищали
зверств: зверство
здес: здесь
земел: земель
земл: земли
знак: знак
знат: знать
знать: знатью
значени: значение
зон: зоной
играет: играет
из: из
известиях: известиях
издан: издана
изуч: изучая
илгас: илгасы
иль: иль
им: им
имел: имели
имен: имена
именн: именно
импер: империями, имперское
императорск: императорской
императриц: императрицы
импери: империи
империя: империя
имперски: имперские
имперским: имперским
информаци: информации
ирин: ирина
иртыш: иртыша
исконны: исконные
исмаил: исмаил
исследовани: исследование
истор: историей
истори: истории, историю
историче: исторических
историческ: исторической, историческом
исторически: исторические
история: история
источниках: источниках
итог: итогом
их: их
июл: июле
июля: июля
йылгас: йылгасы
кабак: кабаки
кавказ: кавказ, кавказа
кавказск: кавказского
казак: казаками, казаков
казачь: казачье
как: как, какого
калмык: калмыков
канака: канакай
кантемир: кантемир
капитуляци: капитуляции
кар: кара
карагул: карагулов
карательн: карательными, карательных
карт: карты
картин: картину
кас: касым
каса: касай
касаев: касаевский
каспулат: каспулат
каспулатов: каспулатовский
кафедр: кафедры
кекуатов: кекуатова
келембет: келембет
керейт: керейтов
керменчик: керменчик
кидирнияз: кидирниязов
кинбурн: кинбурн
кинулис: кинулись
кладбищах: кладбищах
класс: класса
ключевы: ключевые
книг: книга, книги
княз: князь
кобанш: кобаншы
когд: когда
колонизация: колонизация
колонизироват: колонизировать
команд: команды
командир: командиры
командовани: командованием
комендант: комендант
конны: конные
конфликт: конфликт
коренн: коренной, коренных
корн: корни
корпус: корпус, корпуса, корпусов
косил: косили
котор: которая, который
которы: которые
кочевал: кочевал
кочевья: кочевья
краевед: краеведа
крайн: крайне
краснодарск: краснодарского
края: края
крепост: крепостей, крепости, крепость
круг: круга, кругу
крым: крым, крыма, крымское, крыму
крымск: крымского
кубан: кубани, кубанская, кубань
кубанск: кубанского, кубанской
кубански: кубанские
кубанц: кубанцев, кубанцы
кугу: кугуй
культурн: культурных
культурны: культурные
кум: куме
курам: курама
лаб: лаба, лабы
лежал: лежали
леонть: леонтьев
лет: лет
лешкевич: лешкевич
лист: листая
литератур: литературы
лиш: лишь
лоовски: лоовские
лук: луки
лучш: лучшем
люд: людей, люди
майор: майоров
мал: мало
мамбет: мамбет
манычск: манычской
мбо: мбоу
межд: между
меня: меня
месяц: месяцев
мечетях: мечетях
мигрировал: мигрировали
миллион: миллион, миллиона
мир: мира, мире, миру
мирн: мирному
мног: много
многолюдны: многолюдные
моздокск: моздокской
молитв: молитвы
монографи: монографий
мор: морем
мороз: морозы
москв: москва
мощ: мощь
мурз: мурз, мурза, мурзу, мурзы
мурзабеков: мурзабекова
мусавес: мусавес
мусал: мусаль
мы: мы
над: надо
называют: называют
нам: нами
намаз: намаз
намечалос: намечалось
нанест: нанести
нападает: нападает
напаст: напасть
народ: народ, народа, народами, народов, народы
народностям: народностям
нас: нас
населения: населения
настигл: настигли
насчитывает: насчитывает
наук: наук
наурузов: наурузовский
научн: научный
находилис: находились
начал: начал, начала, начале
началис: начались
началос: началось
начался: начался
начинается: начинается
наш: наша, наши, наших
нашим: нашими
невинн: невинных
недостат: недостать
независим: независимая
незаметн: незаметно
нейтральн: нейтральной
некогд: некогда
некоторы: некоторые
нем: нем
немногочисленн: немногочисленным
неожиданн: неожиданно
нескольк: нескольких, несколько
несмотря: несмотря
нет: нет
ни: ни
ник: никого
нов: новыми
новороссий: новороссийский
новрузовским: новрузовским
нога: ногаев, ногаи
ногай: ногайских
ногайск: ногайского, ногайской
ногайски: ногайские
ногайским: ногайским
ногайску: ногайскую
ногайц: ногайцам, ногайцев, ногайцы
ноч: ночь
нурадин: нурадин
нынешн: нынешнего
об: об
обеим: обеим
обескровлен: обескровлена
обозрени: обозрение
образовани: образование
обратил: обратил
обществ: обществу
обществознания: обществознания
огон: огонь
однак: однако
одним: одними
ожесточённ: ожесточённый
октября: октября
он: он
она: она
они: они
орак: орак
орд: орд, орда, орде, орды
оружи: оружии
оружия: оружия
осман: османо, османская
османск: османской
основн: основное
особенн: особенно
оставшаяся: оставшаяся
оставшимся: оставшимся
осталас: осталась
осталис: остались
осталос: осталось
остальн: остальных
остатк: остатки
от: от
отбивает: отбивает
отброс: отброс
ответил: ответили
отвлекавш: отвлекавшего
отдохнут: отдохнуть
отказывавшихся: отказывавшихся
открыт: открытой
отменял: отменял
отодвинул: отодвинули
оторопел: оторопели
отрывок: отрывок
отряд: отряд, отряда, отрядов, отрядом, отряды
отступ: отступая
оттеснен: оттеснены
оттуд: оттуда
офицер: офицера
очередн: очередной
павш: павших
педагогическ: педагогического
перв: первой, первых
перевал: перевалы
перевес: перевес
перед: перед
передан: переданы
перейд: перейдем
переправившис: переправившись
переправилис: переправились
перерезанн: перерезанным
переселения: переселения
переселилис: переселились
переселит: переселить
переселиться: переселиться
перешл: перешли
период: период
пир: пир
пламя: пламя
план: планы
планировалос: планировалось
племен: племени
племя: племя
плен: плен
повстанц: повстанцам
погиб: погиб
погибл: погибли, погибло
поголовн: поголовно
под: под
подальш: подальше
поделиться: поделиться
подкреплени: подкреплений
подкумк: подкумке
подошл: подошли
подсчетах: подсчетах
показал: показали
покрылас: покрылась
политиче: политических
политическ: политического
полк: полков
половин: половине, половины
поминают: поминают
помощ: помощь
понимания: понимания
пономаренк: пономаренко
попытк: попытка
поражен: поражен
поражени: поражением
поражения: поражения
поручик: поручик, поручика, поручику
посвятил: посвятил
посередин: посередине
посл: после
послед: последней
последн: последних
последни: последние
последстви: последствии
последствия: последствия
пост: пост
постигл: постигла
пострадал: пострадали
потемкин: потемкин, потемкина
потер: потерь
потерпел: потерпели
потерял: потеряла
потомк: потомки
потушит: потушить
поход: походами
похолодал: похолодало
поч: почему
почт: почти
пошел: пошел
пошёл: пошёл
появился: появился
пояс: пояс
правительственн: правительственным
правобережья: правобережья
предательств: предательством
предк: предков
предписал: предписал
предпоследне: предпоследнее
предыдущи: предыдущие
предыстори: предыстории
прекратил: прекратили
премьер: премьер
преподавания: преподавания
преследовал: преследовала
преследоват: преследовать
при: при
приближени: приближении
привел: привела
признавал: признавала
признал: признала
прикрыти: прикрытием
принимал: принимали
принял: принял
припас: припасов
притоках: притоках
приход: приходом
причин: причина, причинам
пришлос: пришлось
проблем: проблемы
проверят: проверять
провест: провести
проводил: проводили
проживавшим: проживавшим
произведени: произведение
прорвалас: прорвалась
проснулис: проснулись
пространств: пространство
против: против
процесс: процессе
прочим: прочим, прочими
пушек: пушек
пыталас: пыталась
пят: пять
пятигорья: пятигорья
работах: работах
равнин: равнину
рад: ради
радиус: радиусе
разбил: разбил
развернувшееся: развернувшееся
развития: развития
разгр: разгром
разграблен: разграблен
раздеты: раздетые
разорен: разорен, разорены
район: район, районе
ранен: раненым, ранеными
ранни: ранние
располагалас: располагалась
рассвет: рассвете
рассеялся: рассеялся
рассеян: рассеяны
рассказан: рассказаны
растерял: растеряла
рауциус: рауциуса
редут: редутов
резк: резко
рейд: рейды
рек: реке, реки, реку
речк: речки
решил: решил, решили
род: роду
родн: родной
родны: родные
родоплемен: родоплеменного
родственн: родственных
рол: роль
росс: россией
росси: россии
россий: российская, российский
российск: российской
российски: российские
руж: ружей
руководител: руководитель
рус: русская, русских
русск: русской
русски: русские
русским: русскими
рф: рф
ряд: ряда, рядов
сабл: сабли
сайдахмедович: сайдахмедович
сал: сали
сам: самая, самого, самое, самом
сар: сары
сво: свое, свои, своих
своим: своим
связ: связи
себя: себя
север: северного, северо
северокавказск: северокавказском
севиндж: севиндж
середин: середине
сери: серию
сибир: сибирь
сил: силами, силе, силы
сильн: сильно, сильный
скорбим: скорбим
слияния: слияния
слов: слова
словар: словарь
смотрел: смотрела
смотря: смотря
снег: снегом
со: со
событи: событий
события: события
совершал: совершали
совершат: совершать
современ: современного
соженн: соженны
солдат: солдат
соловьёв: соловьёва
солтан: солтан, солтана
сопредельн: сопредельными
соседним: соседними
состав: состав, состава
составлял: составляли
состоялос: состоялось
социальн: социально
сош: сош
список: список
справедливост: справедливости
справочник: справочник
спрашиват: спрашивать
спустилис: спустились
сработал: сработали
сражени: сражение, сражении
сражениях: сражениях
ссылаяс: ссылаясь
стал: стал, стали
становился: становился
старик: стариков
старц: старцев
степ: степи, степь
степн: степной
степны: степные
стоит: стоит
сторон: сторону
стоял: стояли
стран: странами
стремилас: стремилась
су: су
сувор: суворов
суворов: суворова, суворову
судьб: судьба, судьбы
существовани: существование
счита: считаем
табун: табунам
тав: тав
так: таки
таки: такие
таку: такую
талант: таланты
там: там
таман: тамани
тапант: тапанта
те: те
телег: телег, телеги
телегах: телегах
темир: темир
тен: тени
тепер: теперь
территори: территории
территориальны: территориальные
тех: тех
технологи: технологии
тог: того
тогд: тогда
тож: тоже
тольк: только
трагедия: трагедия
трагически: трагические
три: три
труп: трупов
тукас: тукас
туман: туман
турци: турции, турцию
тысяч: тысяч, тысячи
тысячн: тысячный
тюрк: тюрки, тюркский
тяжел: тяжелая, тяжело
убил: убили
убит: убито
увековеченн: увековеченной
увидел: увидел
увиден: увиденного
угнетат: угнетать
удален: удалена
удалос: удалось
удар: удар
ударил: ударил
уделяется: уделяется
удивил: удивило
уже: уже
узденям: узденям
узнав: узнав
украинц: украинцами
укреплини: укреплинии
университет: университета
уничтожен: уничтожено
упомянут: упомянуть
ура: урай
ураков: ураковский
ураковски: ураковские
урал: урал
уренг: уренгой
урочищ: урочище
уруп: урупа
устроит: устроить
устройств: устройства
устья: устья
утр: утром
уходил: уходили
участвовал: участвовал
участи: участие
ученик: ученик
учител: учитель
ушл: ушла, ушло
флаг: флаги
формирования: формирования
фрагмент: фрагмент
ханств: ханства, ханство
хитрост: хитрость
ход: ходе
хотел: хотел
храбрость: храбростью
цел: целом
цен: ценой
част: части, часть
человек: человек
через: через
черкес: черкесов
числ: числа
числах: числах
читают: читают
что: что
шагар: шагар
шагир: шагир
шамил: шамиль
шар: шары
шегер: шегерское
шел: шел
школ: школе
шор: шора
штурм: штурм
экономиче: экономических
экономическ: экономического
экономически: экономические
экспедици: экспедицию
экспедициях: экспедициях
эл: эл
эли: эли
эпизод: эпизодов
эскадрон: эскадроны
эти: эти
этих: этих
этниче: этническая
этногенез: этногенеза
этнографиче: этнографическое
это: это, этой
этог: этого
этот: этот
юг: юг
южн: южным
юсуп: юсуп
ялбулган: ялбулганов
яман: яман
