xviiвв: xviiвв
август: августа
алексеев: алексеева
арми: армии
архив: архив
ассоциаци: ассоциации
атаман: атаман
бед: беда
безвод: безводного
бердигестях: бердигестях
берег: берегам
бережн: бережно
биографи: биографию
блеклы: блеклые
близким: близким
блуждают: блуждают
больш: большая
большу: большую
боятц: боятца
боях: боях
брал: брали
будущ: будущих
был: был, было
василия: василия
василь: васильев
вблиз: вблизи
век: века
веках: веках
велики: великие
великим: великими
верн: верный, верными
вернувшис: вернувшись
вес: весь
ветр: ветром
взял: взяли
взяти: взятии
вид: виды
вклад: вклад
владеют: владеют
владимировн: владимировна
внешн: внешне
внимательн: внимательным
внук: внукам, внуки
внутренн: внутренне
вов: вов
войн: войне, войну
воспитания: воспитания
восстановлени: восстановлении
впервы: впервые
впоследстви: впоследствии
время: время
все: все, всей
всегд: всегда
всем: всем
всепрощени: всепрощении
всех: всех
вступил: вступил
втор: вторым
выбир: выбирая
вывозил: вывозил
выделял: выделял
выезд: выезды
выезж: выезжая
вынужденн: вынужденно
выявит: выявить
выяснил: выяснили
галкин: галкин
генеалог: генеалогов
генеалоги: генеалогии
генеалогия: генеалогия
германи: германии
гипотез: гипотеза
глав: главе
главн: главная
го: го
год: года, году
гор: горного
гордость: гордостью
горн: горный
город: города
групп: группы
давал: давали
дала: далай
далек: далеких
дальш: дальше
дария: дария
дархан: дархана
даурия: даурия
два: два
дед: дед
дедушк: дедушке
дерев: дерево
дет: детей, дети
детям: детям
до: до
добр: добрым
добродушн: добродушным
документ: документам
долг: долгу
должн: должны
долин: долины
доминирующу: доминирующую
доносил: доносил
доступ: доступа
дьяконов: дьяконова
его: его
ее: ее
ерт: ерт
ест: есть
жив: живым
жизн: жизни, жизнь
жизнь: жизнью
жирков: жиркова
журналист: журналистов
забайкальск: забайкальского
забот: забот
забыват: забывать
завершил: завершили
завидовал: завидовал
задач: задачи
задолг: задолго
закладываются: закладываются
закономерност: закономерности
закрепляяс: закрепляясь
заняти: занятием
западн: западно
земл: землю
землё: землёю
зимню: зимнюю
злословил: злословил
знал: знал, знали
знат: знать
из: из
издательств: издательство
изуч: изучая
изуча: изучаем
изучени: изучение
изучил: изучили
изучит: изучить
ильин: ильину
ильич: ильича
им: им
имел: имел
именн: именно
империалистическ: империалистической
интервь: интервью
ины: иные
исследования: исследования
истор: историей
их: их
июн: июнь
июня: июня
кажд: каждое
казак: казаков
как: как
кангаласс: кангалассов
кангаласски: кангаласские
кангаласц: кангаласцев
кириллин: кириллина
класс: класса
климат: климате
ключевы: ключевые
км: км
князц: князцы
коллектив: коллектив
комитет: комитета
комсомольск: комсомольского
конц: конце
кор: корней
корсак: корсаков
котор: котором, которым, которых
которы: которые
края: края
кто: кто
куд: куда
ласков: ласковым
лен: лены
лет: лет, лето, летом
лини: линии
листья: листья
литератур: литературы
лукин: лукиной
любв: любви
любил: любил
любим: любимым
любител: любителей
люд: людей, люди
людмил: людмила
людн: людны
людях: людях
мал: малых
мамин: маминой
марин: марина
материал: материал
мбу: мбу
мемориал: мемориал
местност: местности
мир: мире
мне: мне
мног: много
многи: многие
многим: многими
могл: могло
моег: моего
можн: можно
мои: мои
моим: моим
мой: мой
мр: мр
му: му
мы: мы
мысл: мыслей
мыслител: мыслителями
называт: называть
написан: написано
народ: народа
нарый: нарыйа
нас: нас
наслег: наслега
наследствен: наследственного
научн: научный
начал: начал, начале
наш: нашего, нашей
невредим: невредимым
нег: него
ни: ни
нигд: нигде
низким: низким
ник: никому
никогд: никогда
ним: ним
нов: новой
новизн: новизна
нор: нор
носимы: носимые
ноября: ноября
област: области
общался: общался
обществ: общества
обязан: обязаны
односельчан: односельчан
озер: озера
окол: около
олекм: олекму
он: он
она: она
онкучах: онкучах
онучин: онучин
организованн: организованным
организовывал: организовывал
осед: оседая
осен: осень
основ: основы
особ: особо
особенност: особенности
от: от
ответственн: ответственным
отдыхат: отдыхать
отзывчив: отзывчивым
отношени: отношений
оторванност: оторванность
отправн: отправной
отслужив: отслужив
отсрочк: отсрочку
охот: охоту
очен: очень
пастбищ: пастбища
пахом: пахомов
пахомов: пахомова, пахомовых
педагог: педагог
передат: передать
переселения: переселения
переселенц: переселенцами
перм: пермь
петровн: петровна
писал: писал
писател: писателями
плодотворну: плодотворную
побывав: побывав
поддерживал: поддерживал
подряд: подряд
познакомилис: познакомились
познакомиться: познакомиться
поколени: поколением, поколений
поколенн: поколенной, поколенный
полк: полку
помогал: помогал
порядках: порядках
поселилос: поселилось
посл: после
последним: последними
послужит: послужить
пособи: пособие
постепенн: постепенно
потомк: потомков
практиче: практическое
преданиям: преданиям
преданност: преданности
предводителя: предводителя
предк: предки, предков
предках: предках
предприятия: предприятия
прекрасн: прекрасных
преодолени: преодолении
придерживался: придерживался
призван: призван
признал: признали
пример: пример
принадлежат: принадлежат
принят: принято
присвоени: присвоении
притеснени: притеснений
причин: причиной
проблем: проблема
продолжают: продолжают
прокопьевн: прокопьевна
проникновенн: проникновенных
прост: простых
пространств: пространства
против: против
процесс: процесс
прям: прямых
пряталис: прятались
публицист: публицисту
работ: работу
радовал: радовал
развлечени: развлечений
разгром: разгрома
район: района, районе, районного
ранни: ранний
распространилис: распространились
рассказывают: рассказывают
расстояни: расстоянии
ребенк: ребенком
режим: режим
рек: реки, реку
рекомендаци: рекомендации, рекомендацию
республик: республика
род: рода, родного
родился: родился
родител: родители
родн: родным, родных
родну: родную
родословия: родословия
родословн: родословная, родословное, родословной, родословных
родословну: родословную
родств: родстве
рол: роль
роман: роман
роспис: росписи, роспись
рост: ростом
руководител: руководителем, руководитель
рф: рф
рыбалк: рыбалку
ряд: ряды
сах: саха
сахалинск: сахалинской
сбор: сбора
сведения: сведения
сво: свое, своего, своей, своему, свои, своих, свою
своим: своим, своими
связ: связи
сделат: сделать
сейчас: сейчас
семейн: семейном, семейный
семеновн: семеновна
семь: семье, семьей, семьи
семья: семья
сенокосны: сенокосные
сиинэ: сиинэ
синяя: синяя
систематизировал: систематизировали
систематизироват: систематизировать
сказан: сказано
скольк: сколько
скотовод: скотоводы
слов: слов, слова
служб: службу
служил: служил
со: со
соболоох: соболоох
советск: советской
современн: современном
составил: составили
составит: составить
составлени: составление, составлению
союз: союза
союзническ: союзническому
список: список
срастаяс: срастаясь
сред: средней
ссср: ссср
становится: становится
становяс: становясь
станци: станции
степанович: степанович
стих: стихов
стрелков: стрелковом
строитель: строительного
судьб: судьбы
сует: суеты
считаются: считаются
таблиц: таблиц
так: такого
таким: таким
тво: твое
территори: территории
тольк: только
точк: точкой
традиционну: традиционную
традициях: традициях
требовательн: требовательным
тыгын: тыгына, тыгыном
убегал: убегали
угодья: угодья
удивлял: удивлял
уже: уже
узнал: узнали
улиц: улицы
улус: улус
успел: успел
установил: установили
устоях: устоях
уу: уу
участвовал: участвовал
участк: участке
учениц: ученица
учён: учёными
фашистк: фашисткой
философ: философами, философу
форм: форме
фотограф: фотографиями
фотографировани: фотографирование
фронт: фронта
ха: ха
хайлар: хайлар
хангалас: хангаласский
хангаласц: хангаласцы
хранит: хранить
цдо: цдо
цел: цель
ценност: ценность
центр: центра
человек: человека
человече: человеческая, человеческих
чем: чем
через: через
член: члена, членов
что: что
чутким: чутким
шологонск: шологонского
эллэя: эллэя
эти: эти
этногенез: этногенеза
этносоциальны: этносоциальные
это: это
южн: южно
являемся: являемся
якут: якуты
якутия: якутия
якутски: якутские
япони: японии
ясак: ясака
ячейк: ячейка
