август: августа
авиационн: авиационным
амановн: амановна
анализируется: анализируется
аннотация: аннотация
арми: армии
артиллерийским: артиллерийским
астрахан: астрахани, астрахань
баз: базу
батальонны: батальонные
бел: белых
берег: берег, берега, берегу
беспримерн: беспримерное
битв: битва, битве, битвы
ближ: ближе
боев: боевых
боеву: боевую
бои: бои
боле: более
больн: больных
больш: большое, большой
бомбардировк: бомбардировки
боровшихся: боровшихся
борьб: борьбы
был: был, были, было
важну: важную
ведомост: ведомости
велик: великой
вероятност: вероятность
вес: весь
вест: вести
витехнов: витехновская
вмест: вместе
вод: водного
воен: военного
военврач: военврача
воениздат: воениздата
военн: военно, военных
возвращающемся: возвращающемся
возможност: возможности
возникновения: возникновения
возрастал: возрастал, возрастало
возросл: возросла
войн: войну, войны
волг: волга, волге, волги
волгоградск: волгоградского
воробьёв: воробьёв
враг: врагом
врач: врачей
времен: времени
время: время
все: все, всей
всег: всего
вспышек: вспышек
вынуждал: вынуждало
выполнит: выполнить
выполнят: выполнять
выступал: выступало
гг: гг
где: где
германск: германского
героизм: героизма
гигантск: гигантского
главн: главное
год: года
город: город, города, городе
госпитал: госпиталей, госпитали
госпитальн: госпитальное
госпитальну: госпитальную
госпиталя: госпиталя
государственн: государственное, государственный
грандиозн: грандиозных
гсд: гсд
дальнейш: дальнейшем
данил: данилов
два: два
двинулся: двинулся
действи: действий
дел: дела
ден: день
десятк: десятки
детьм: детьми
динар: динара
дмитри: дмитрий
дне: дней
дня: дня
до: до
доклад: доклад
дон: дон
дополнитель: дополнительного
доставк: доставки
достигл: достигло
ежедневн: ежедневно
ежов: ежов
железнодорожн: железнодорожная
жизн: жизни
жил: жилого
заболевани: заболеваний
задач: задачи, задачу
закончит: закончить
замечательны: замечательные
запад: западного
западн: западных
зачасту: зачастую
здания: здания
здравоохранения: здравоохранения
значени: значение
зон: зоне
игравши: игравшие
из: из
издательств: издательств, издательство
им: им
имеет: имеет
имен: имени
иногд: иногда
институт: институтов
инструктор: инструкторов
инфекционн: инфекционных
испытани: испытанием
истори: истории
их: их
июля: июля
кавказ: кавказом
кажд: каждого
как: как
канализационн: канализационной
кандидат: кандидат
кафедр: кафедра, кафедры
качалкин: качалкина
километр: километров
ключевы: ключевые
книжн: книжной
когд: когда
коек: коек
количеств: количество
котор: которых
кра: крае
красн: красной
красноармейц: красноармейцев
кровопролитн: кровопролитных
крупнейшу: крупнейшую
крупны: крупные
курмангазиев: курмангазиева
лев: левый
ленинград: ленинграда
лет: лету
лечения: лечения
литератур: литературы
лл: лл
маршал: маршала
масс: масса
массов: массового
медгиз: медгиз
медик: медики, медиков
медицин: медицина, медицинский, медицинских, медицины
медицинск: медицинского, медицинской
медицински: медицинские
медсанбат: медсанбата, медсанбатов
мерин: меринов
мероприяти: мероприятий
местны: местные
месяц: месяцы
метр: метров
можн: можно
молодёжн: молодёжной
мужеств: мужество
навсегд: навсегда
налет: налета, налеты
наличи: наличие
нам: нами
направлен: направлено
наркомздрав: наркомздрав
населения: населения
наук: наук
научн: научный
находившихся: находившихся
находилас: находилась
находилис: находились
находился: находился
начал: начали, началу
начальник: начальника
невозможн: невозможной
недопущени: недопущение
немц: немцам
необходимост: необходимость
необходимы: необходимые
неоценим: неоценимое
непосредственн: непосредственной, непосредственном
нескольк: несколько
неспециализированн: неспециализированном
нехватк: нехватке
ним: ним
нко: нко
ночь: ночью
ноябр: ноябре
област: областей, области, областного, область
областн: областной
облисполком: облисполкома
оборон: обороны
оборонительн: оборонительных
обслуживания: обслуживания
обстановк: обстановка
обстрел: обстрелами, обстрелов
обуславливал: обуславливало
общественн: общественных
обязанност: обязанности
огн: огнем
огромн: огромной
одн: одни, одно
однак: однако
ожесточенне: ожесточеннее
оказал: оказал
оказания: оказания
оказывалис: оказывались
окол: около
октября: октября
олегович: олегович
она: она
оп: оп
опасност: опасность
операционн: операционная
орган: органы
организаци: организации
организация: организация
оренбург: оренбург, оренбургский
основн: основная
особ: особо
останутся: останутся
остающийся: остающийся
от: от
отдел: отдела
отделени: отделение
отделял: отделяли
отечеств: отечества
отечественн: отечественной
откуд: откуда
отряд: отрядов
отсутстви: отсутствие
отчаянн: отчаянных
отчетн: отчетный
офсет: офсет
памят: памяти
партийн: партийной
пассажир: пассажирских
перв: первой, первый, первых
первостепенны: первостепенные
первы: первые
переведен: переведены
перевозках: перевозках
перегрузк: перегрузкой
передн: переднем
переломн: переломных
переправлен: переправлено
период: период
персонал: персонала
петербургски: петербургские
план: план, планов
плеч: плечом, плечу
побед: победы
погод: погоды
под: под
подвиг: подвиг
подлинн: подлинной
подходил: подходил
поезд: поездов
пожар: пожара
полев: полевых
полиграфи: полиграфии
политик: политики
полковы: полковые
полность: полностью
половин: половины
помещени: помещений
помогл: помогла
помощ: помощи, помощь
понимания: понимания
пор: порой
посл: после
последовавш: последовавшего
постоянн: постоянной
поступал: поступали
поступающ: поступающих
поток: поток
потребовал: потребовали
потребовалос: потребовалось
прав: правого, правом
превратилас: превратилась
превращен: превращен
превышающ: превышающей
преподавател: преподаватель
при: при
прием: приема
принимал: принимал
припас: припасов
прифронтов: прифронтовых
приходилос: приходилось
пробиться: пробиться
проблем: проблемой
продолжающиеся: продолжающиеся
промышленност: промышленность
промышленны: промышленные
прорыв: прорыв
пространств: пространства
противник: противника
противоэпидемиче: противоэпидемических
профессионализм: профессионализм
проходил: проходила
проявил: проявили
прям: прямо
пулеметн: пулеметным
пункт: пунктов, пункты
работ: работе, работу
работал: работали, работало
работник: работники, работников
рабоч: рабочих
развернут: развернуто
развертывалис: развертывались
развертывани: развертывание
развертыват: развертывать
развит: развитая
размещалос: размещалось
размещат: размещать
разрушен: разрушены
район: районов
ранг: ранга
ранен: раненым, раненых
ранены: раненые
рассредоточени: рассредоточение
резк: резко
результат: результате
рек: реки
ресторан: ресторане
ресурс: ресурс
решал: решали
рол: роль
рубеж: рубежей
ружейн: ружейно
руин: руины
руинах: руинах
руководител: руководитель
руководств: руководством
рф: рф
сам: самом, самый, самых
самоотверженност: самоотверженность
санитарн: санитарное, санитарных
санкт: санкт
сарат: саратов
свыш: свыше
связ: связи
сд: сд
северн: северным
сель: сельское
сестер: сестер
сет: сеть
сильн: сильных
символ: символом
систем: системы
слов: слова, словами
совершен: совершенного
совет: советских
советск: советско, советского
соединявш: соединявшая
создавал: создавали
солдат: солдат, солдаты
сосредоточен: сосредоточено
состояни: состоянии
сотен: сотен
союз: союза
спас: спасая
спаст: спасти
список: список
способствовал: способствовало
сражени: сражений
ссср: ссср
стал: стала
сталинград: сталинград, сталинграда, сталинграде, сталинградская, сталинграду
сталинградск: сталинградского, сталинградской
становилас: становилась
старши: старший
стран: страны
стратегиче: стратегических
страш: страшного
строительн: строительных
строительств: строительстве
студент: студент
судоходны: судоходные
суров: суровым
сутк: сутки
существ: существу
тен: тени
территори: территории
тимошенк: тимошенко
типография: типография
тогд: тогда
тольк: только
торговл: торговли
транспорт: транспорте
требовал: требовало
труб: трубе
трудность: трудностью
тыл: тыла, тылу
тысяч: тысяч
тяжел: тяжелый
тяжёл: тяжёлых
увеличения: увеличения
удавалос: удавалось
уже: уже
украин: украиной
университет: университет
уничтожен: уничтожено
управлени: управление
управления: управления
усилени: усиление
услов: условиями
условия: условия
условиях: условиях
устремился: устремился
ухудшилас: ухудшилась
участилис: участились
участк: участке
училищ: училищ
учреждения: учреждения
фашист: фашистов
фонд: фонда
фронт: фронт, фронта, фронтов
халатах: халатах
хозяйств: хозяйство
хозяйственн: хозяйственных
хозяйственны: хозяйственные
хорош: хорошая
хотелос: хотелось
цднив: цдниво
цен: цены
центр: центром
част: часто
чем: чем
числ: числа, число
чуйков: чуйкова
шла: шла
шли: шли
штатны: штатные
штольн: штольне
эвакогоспитал: эвакогоспиталей
эвакопункт: эвакопункта
эвакуаци: эвакуацию
эвакуационн: эвакуационная
эвакуационны: эвакуационные
эвакуация: эвакуация
эвакуирован: эвакуированного
эг: эг
экономик: экономике
экстремальны: экстремальные
электронн: электронный
эти: эти
это: это
этом: этом, этому
эффективн: эффективной
эшелон: эшелонов
юго: юго
южн: южного, южном
