автоматизированн: автоматизированным
автор: автор, авторов, автором
адаптаци: адаптации
адаптирован: адаптировано
адаптироваться: адаптироваться
академиче: академическое
активн: активно, активное, активной
алекс: алексей
анализирует: анализирует
атомн: атомной
баз: базой, базы
безопасност: безопасность
богат: богата
боеприпас: боеприпасов
боле: более
будущи: будущие
был: была, были, было
быт: быть
важн: важным
важну: важную
ведущим: ведущими
век: века
велик: великой
весом: весомый
взаимодействи: взаимодействие
вклад: вклад
включ: включая
владимировн: владимировна
власт: власти
внедрят: внедрять
внес: внес
внесл: внесли
вносит: вносить
военн: военной, военных
военну: военную
возможност: возможность
возникл: возникла
войн: войны
востребован: востребованы
востребованн: востребованными
время: время
все: все, всей
всегд: всегда
втор: второй
вуз: вузов
вызов: вызовам, вызовами
вынужден: вынуждены
выпускал: выпускали
выпускник: выпускникам, выпускники, выпускников, выпускником
высок: высокое, высокой, высоком
высококвалифицированн: высококвалифицированными, высококвалифицированных
высококвалифицированны: высококвалифицированные
высокотехнологичн: высокотехнологичных
высокотехнологичны: высокотехнологичные
высш: высшем
где: где
говорит: говорить
год: годы
годах: годах
горбун: горбунов
город: городе
государственн: государственный
дел: дело
деревообработк: деревообработки
динамик: динамику
дисциплин: дисциплин
длительну: длительную
до: до
добилис: добились
доктор: доктора
достижения: достижения
др: др
друг: других
други: другие
другим: другим
его: его
ее: ее
екатеринодар: екатеринодаре
елен: елена
железнодорожн: железнодорожное, железнодорожной
жизн: жизни
заведен: заведениями
заведени: заведении, заведений
заведения: заведения
заведениях: заведениях
заключается: заключается
зелен: зеленская
знан: знаниями
знани: знаний
знания: знания
значени: значение, значении
значим: значимый
значимост: значимость
значительн: значительно, значительное, значительный, значительных
значительну: значительную
играл: играли
играт: играть
из: из
известн: известным, известных
известны: известные
издательств: издательство
изменени: изменений
изменения: изменения
изобретения: изобретения
изучал: изучали
им: им
имеет: имеет
имел: имели
имеют: имеют
императорск: императорского
индустри: индустрию
индустриализац: индустриализацией
индустриализаци: индустриализации
индустриальн: индустриальной
инженер: инженером, инженеры
инновациям: инновациям
интегрирован: интегрированы
информатик: информатику
информационн: информационных
исследовани: исследовании
истори: истории, историю
историческ: исторического
история: история
их: их
кадр: кадрами, кадров
кадров: кадрового
как: как
качеств: качества, качество, качеством
качественн: качественное
квалифицированн: квалифицированных
клуб: клуб
ключеву: ключевую
ключевы: ключевые
коллектив: коллектив
компаниях: компаниях
компетенци: компетенций
компьютерн: компьютерных
конструктор: конструктором
конструкци: конструкции
контекст: контекста
конц: конце
котор: которое, который
которы: которые
кра: крае
краснодар: краснодар, краснодаре
краснодарск: краснодарского, краснодарском
края: края
кубан: кубанский
культур: культуры
лебед: лебедев
литератур: литературы
лиш: лишь
люд: людей
мастер: мастерских
мастерски: мастерские
машиностроени: машиностроение
машиностроения: машиностроения
местн: местных
металлообработк: металлообработки
методик: методиками, методики
механик: механике
многи: многие
многочисленны: многочисленные
множеств: множество
моделировани: моделирование
молод: молодых
мор: море
морск: морского
москаленк: москаленко
москв: москва, москве
муравь: муравьев
мысл: мысль
навык: навыками, навыки, навыков
названи: название
найден: найдены
направленност: направленности
населения: населения
настояще: настоящее
наталья: наталья
наук: наук, науки
начал: начале, начали, началом
начин: начиная
необходим: необходимое, необходимыми
необходимост: необходимость
необходимы: необходимые
нескольк: нескольких, несколько
нов: новым, новыми, новых
новороссий: новороссийская
новы: новые
носил: носила
нужн: нужными
нын: ныне
обеспечения: обеспечения
обеспечив: обеспечивая
обеспечивал: обеспечивали
обеспечиват: обеспечивать
обеспечивают: обеспечивают
област: областей, области
областям: областям
областях: областях
оборонительн: оборонительных
оборудования: оборудования
образ: образом
образовани: образование, образовании
образования: образования
образовательны: образовательные
обучалис: обучались
обучени: обучение, обучении
обучения: обучения
обществ: общества, общество
общественн: общественных
одним: одним
окончания: окончания
он: он
она: она
они: они
оно: оно
опыт: опыт, опыта
ориентирован: ориентированы
оружия: оружия
освоени: освоение
основ: основы
основн: основная
особенн: особенно
от: от
ответ: ответом
отечественн: отечественной
открыв: открывая
открыт: открыта, открыто, открыты
отличалис: отличались
отличалос: отличалось
отражает: отражает
отражат: отражать
отражающу: отражающую
отрасл: отраслей, отрасли
отраслях: отраслях
охватыват: охватывать
охватывают: охватывают
патент: патентов
перв: первая, первых
первоначальн: первоначально
первы: первые
передач: передачи
передов: передовыми
перейт: перейти
пересматриват: пересматривать
период: период, периода
петербург: петербург, петербургский
петр: петров
повлиял: повлиял
повседневн: повседневной
повышени: повышению
подготавливал: подготавливали
подготовк: подготовка, подготовке, подготовки, подготовку
подготовленн: подготовленных
подразделени: подразделением
подробн: подробно
позволил: позволили
позволял: позволяло
полагалос: полагалось
половин: половины
получал: получали
получил: получил, получила
получит: получить
поляков: полякова
помог: помогая
помогает: помогает
посл: после
послевоенн: послевоенный
послевоенны: послевоенные
последующим: последующими
потенциал: потенциала
потребност: потребности, потребностями
потребностям: потребностям
потребностях: потребностях
появилис: появились
практик: практику
практическ: практической
практически: практические
практическим: практическими
предлагал: предлагала
предоставлял: предоставляли
предоставлят: предоставлять
предпринимательств: предпринимательства
предприят: предприятиями
предприяти: предприятий
предприятия: предприятия
предприятиям: предприятиям
предприятиях: предприятиях
преподавания: преподавания
преподавател: преподаватель
престиж: престижем
привлекают: привлекают
применени: применение
пример: примеров, примером
приобрест: приобрести
приобретат: приобретать
программ: программного, программы
программировани: программирование
прогресс: прогресса
продолжает: продолжает
продолжал: продолжали
продолжалос: продолжалось
продолжил: продолжил, продолжила
продукци: продукции
производств: производства, производстве, производство
производственн: производственными
промышленн: промышленных
промышленност: промышленности, промышленность
промышленны: промышленные
простейши: простейшие
профессионал: профессионалов
профессиональн: профессионально, профессиональное, профессиональных
профессиональну: профессиональную
проходит: проходить
процесс: процессами
прошл: прошлое, прошлом
работ: работ, работы
работах: работах
работник: работников
рабоч: рабочих
рабочи: рабочие
рабочу: рабочую
развиваться: развиваться
развити: развитие, развитием, развитии, развитию
развития: развития
различн: различных
разнообразн: разнообразна
разработк: разработки
разработчик: разработчиком
рамках: рамках
рассматривается: рассматривается
растущ: растущей
растущи: растущий
расширени: расширении
регион: регион, региона, регионе
региональ: регионального
региональн: региональной
регионах: регионах
ремесленн: ремесленном, ремесленных
реформ: реформами
робототехник: робототехнику
рол: роль
росси: россии
рф: рф
рынк: рынка, рынке
рыночн: рыночной, рыночным
сам: самых
санкт: санкт
свидетельствуют: свидетельствуют
сво: свое, своего, своей, своих, свой
своим: своим
связ: связи, связь
связан: связаны
сделат: сделать
сегодня: сегодня
сельск: сельского, сельском
середин: середине
сет: сети
сил: силу
систем: системам
слов: слова
смирн: смирнов
со: со
совершенствовани: совершенствованию
совершенствоваться: совершенствоваться
советск: советской
современ: современного
современн: современной, современным
современност: современность
современны: современные
создан: созданы
создани: создание
соответственн: соответственно
соответствоват: соответствовать
соответствует: соответствует
состояни: состояние
сотрудник: сотрудники
социальн: социально
сочин: сочинская
спектр: спектр
специализаци: специализации
специализированн: специализированной, специализированных
специализированны: специализированные
специалист: специалистами, специалистов, специалистом, специалисты
специалистах: специалистах
специальн: специальное
список: список
способствовал: способствовало
способствует: способствует
спрос: спрос
стажировк: стажировки
стал: стал, стали, стало
сталкиваться: сталкиваться
стандарт: стандартам
становилис: становились
стать: статье, статьи
степен: степень
стран: стране, страны
стремлени: стремлением
строительств: строительства
студент: студентов, студенты
судов: судового
судостроения: судостроения
судостроительн: судостроительной
существенн: существенно
сфер: сфера, сфере, сферы
сыграл: сыграли
так: таких
таки: такие
таким: таким
тесн: тесно
техник: техники
техникум: техникума, техникумов, техникумы
техниче: техническая, технический, технических, техническое
техническ: технически, технического, технической, техническом
технически: технические
технолог: технологиями
технологи: технологии, технологий
технологическ: технологического
технологически: технологические
технологическим: технологическим
товар: товаров
тольк: только
традиционн: традиционных
традиционны: традиционные
требованиям: требованиям
требующи: требующие
труд: труда
углублят: углублять
удовлетворит: удовлетворить
удовлетворяя: удовлетворяя
улучшит: улучшить
университет: университет
уникальны: уникальные
уровн: уровне
уровня: уровня
условиям: условиям
успех: успех, успехов
участвовал: участвовали
учащиеся: учащиеся
учеб: учебного
учебн: учебной, учебном, учебными, учебных
учебник: учебник
учебны: учебные
ученик: учеников
училищ: училищ, училища
учреждения: учреждения
фгбо: фгбоу
фирм: фирмами
флот: флота
фокусироваться: фокусироваться
формировани: формированием, формировании
формирования: формирования
хозяйств: хозяйства, хозяйстве
хотят: хотят
цел: целом
ценн: ценный
центр: центрами, центров
что: что
шаг: шагом
широк: широкое
широки: широкий
школ: школ, школа, школе, школы
школах: школах
экономик: экономики
экономиче: экономическая, экономических
экономическ: экономической
электромеханик: электромеханики
электроник: электронике, электронику
электротехник: электротехника, электротехнике
энергетик: энергетики
эти: эти
этих: этих
это: это, этой
этот: этот
эффективн: эффективно, эффективной
является: является
являются: являются
ядерн: ядерной
