автор: авторы
акмулл: акмуллы
актив: активного
активизаци: активизации
активн: активно, активное
активност: активности
актуальност: актуальность
акцентировал: акцентировал
алферов: алферова
анализирует: анализирует
аннотация: аннотация
аппарат: аппарате
апрел: апрель
арманд: армандом
артюхин: артюхина
археографиче: археографический
башкир: башкирский
боле: более
большевизм: большевизма
большевик: большевиков
большевистск: большевистской
больши: большие
борьб: борьбу, борьбы
был: был, была, были, было
быт: быть
бюрократи: бюрократии
бюрократическим: бюрократическими
важн: важно, важное
важност: важность
важность: важностью
важну: важную
варьировал: варьировало
вестник: вестник
включ: включая
включал: включала, включали
включени: включении
вкп: вкп
власт: власти, власть
влияния: влияния
влият: влиять
вмест: вместо
внимани: внимание
возлагал: возлагал
возможност: возможность
вопрос: вопросов
воспитания: воспитания
воспоминания: воспоминания
вошл: вошли
времен: временем, времени
время: время
всеобщ: всеобщей
всероссийск: всероссийском
встречах: встречах
втор: второй
выбирал: выбирали
выбиралис: выбирались
выбор: выбора, выборов, выборы
вывод: вывод
выйт: выйти
выполнял: выполняли
высок: высоких
гг: гг
где: где
глав: глава
главн: главной
год: года, годам, годов, году, годы
город: городов
городах: городах
госконтроля: госконтроля
госполитиздат: госполитиздат
государств: государства, государство, государством
государствен: государственного
государственн: государственное, государственный
граждан: гражданами
грамотност: грамотности
губерниях: губерниях
гулширин: гулширин
давал: давало
дал: дали
движения: движения
действовал: действовали
дек: дек
декабр: декабрь
декрет: декреты
делах: делах
делегат: делегатов, делегатских
делегатк: делегатка, делегатки
делегаток: делегаток
делегатски: делегатские
делегатским: делегатскими
делегатств: делегатства
депутат: депутатов
деревнях: деревнях
дет: детей
деятельност: деятельности, деятельность
диктатур: диктатуры
до: до
должностям: должностям
достиг: достигая
достигал: достигало
едины: единые
ещё: ещё
женотдел: женотделами, женотделов, женотделы
женским: женскими
женщин: женщин, женщины
жизн: жизни
жилищн: жилищными
жительств: жительства
заводах: заводах
задач: задача, задачи
зажиточн: зажиточных
заканчив: заканчивая
заключени: заключение
закрепивше: закрепившее
занималис: занимались
занимающиеся: занимающиеся
записк: записке
заседаниях: заседаниях
зат: затем
здес: здесь
здоровья: здоровья
здравоохранени: здравоохранение
здравоохранения: здравоохранения
значени: значение
значимост: значимость
значительн: значительным
идеологическ: идеологического, идеологической
идеологическим: идеологическими
идеология: идеология
избиралас: избиралась
избрания: избрания
изд: изд
издательств: издательство
изменения: изменения
изменениям: изменениям
изменялся: изменялся
изменяющейся: изменяющейся
илжановн: илжановна
им: им
имен: имени
инициатив: инициатива
иногд: иногда
инспекци: инспекцию
институт: институт, института
инструмент: инструментом
интерес: интересы
использовал: использовало
использовалис: использовались
истори: истории, историю
итог: итоге
их: их
казармах: казармах
казачь: казачьих
как: как
кампани: кампаний
кафедр: кафедра
качеств: качеств
клубах: клубах
ключев: ключевым
ключевы: ключевые
количеств: количество
коммунистк: коммунистка
конечн: конечном
контекст: контексте
контрол: контроле, контроль
контролировани: контролирование
контроля: контроля
конц: концу
кооперативах: кооперативах
котор: которая, которой, которому
которы: которые
красноармей: красноармейских
крестьян: крестьянских
крестьянок: крестьянок
крестьянств: крестьянство
круп: крупская
крупн: крупных
культурн: культурным
лекци: лекции
ленин: ленин, ленина
лидер: лидерских
литератур: литературы
лучш: лучшая
магистрант: магистрант
масс: масс, массами
массов: массовых
массовы: массовые
масштабн: масштабными
медицин: медицинских
мене: менее
мероприяти: мероприятий
мест: место, месту
местах: местах
местн: местными, местных
местност: местности
месяц: месяцев
метод: методы
мировоззрения: мировоззрения
мобилизация: мобилизация
мог: мог
могл: могли
модернизаци: модернизации
можн: можно
морал: морали
московск: московской
мужчин: мужчинами
навык: навыки, навыков
надежд: надежды
направленн: направленных
например: например
наркомат: наркомат
населени: населению
населения: населения
начал: начал, начале, начали
начальн: начальном
начин: начиная
необходим: необходимым
неоднородн: неоднородным
непосредственн: непосредственной
нов: новое
нурыев: нурыева
об: об
обеспечивал: обеспечивали
обеспечит: обеспечить
образ: образом
образовани: образование
образования: образования
образовательн: образовательных
обращают: обращают
обсуждал: обсуждали
обсуждалос: обсуждалось
обсуждения: обсуждения
обще: общее
обществ: общества, обществе
общественн: общественная, общественной, общественных
общественны: общественные
одинаковы: одинаковые
одн: одна, одного
однак: однако
оказалис: оказались
окол: около
октябрьск: октябрьской
они: они
определялис: определялись
органах: органах
организатор: организаторы
организаци: организации
организациях: организациях
организован: организована
организовываться: организовываться
ориентирован: ориентированы
освещается: освещается
ослаблени: ослаблению
основн: основной
особенн: особенно
осуществлят: осуществлять
от: от
отдел: отделы
отечественн: отечественной
отказ: отказе
отметит: отметить
отношени: отношений
отстал: отсталыми, отсталых
отчёт: отчёт
официальн: официально
парти: партии
партийн: партийных
партийны: партийные
патриархаль: патриархального
педагогиче: педагогический
первостепенн: первостепенной
первы: первые
перерыв: перерывов
перестал: перестали
переход: переход
период: период
петроградск: петроградской
планировалис: планировались
площадк: площадкой
повлият: повлиять
повышени: повышению
подготавливал: подготавливало
подготовк: подготовки
поддержк: поддержки
подобн: подобное
подтверждается: подтверждается
подчеркивал: подчеркивал
полезн: полезных
политиздат: политиздат
политическ: политической
политически: политические
политическим: политическим
полн: полн
полноправн: полноправными
половин: половине
положени: положение
получит: получить
помогал: помогали
порядок: порядок
последни: последние
посред: посреди
постановлени: постановление
потребност: потребностей
появлени: появлению
правд: правда
правил: правила
правильн: правильный
правов: правового, правовое
практик: практику
практиче: практическая
практическ: практической
практически: практические
практическу: практическую
предлагалос: предлагалось
предложен: предложено
предложени: предложением
предприятиях: предприятиях
представительств: представительства
представлял: представляли
представляя: представляя
преобразования: преобразования
преодоления: преодоления
при: при
привел: привела, привело
привлечени: привлечение, привлечении
привлечения: привлечения
призван: призвана
применялис: применялись
принцип: принципам, принципами
принял: принял
принят: принято
приход: приход
пробл: проблем
проблем: проблемами
проведени: проведение
проведения: проведения
проводилис: проводились
проводим: проводимой
проводит: проводить
проект: проект
производств: производством
пройденн: пройденный
пролетариат: пролетариата
промышленн: промышленных
пропагандировалас: пропагандировалась
пропорци: пропорции
профсоюзах: профсоюзах
процесс: процесс, процесса, процессами, процессе
прошл: прошли
пут: путь
пьянств: пьянством
работ: работа, работе, работой, работу, работы
работник: работников
работниц: работниц, работницы
рабоч: рабочих
рабочу: рабочую
равенств: равенства, равенство
развити: развитие, развитием, развитию
развития: развития
различн: различным, различных
различны: различные
разн: разное, разных
разнообразн: разнообразным
разнообразны: разнообразные
разны: разные
райкомах: райкомах
район: районов
районах: районах
рамк: рамки
рамках: рамках
ранн: ранних
распространени: распространение
рассматривается: рассматривается
рассматриваются: рассматриваются
революци: революции
регионах: регионах
резолюц: резолюцией
результат: результате
реорганизоват: реорганизовать
ркп: ркп
род: рода
рол: ролей, роль
росси: россии
российск: российского
руководств: руководства, руководством
руководящим: руководящим
рф: рф
самойлов: самойловой
светск: светской
сво: своего, свою
связанн: связанным
сделал: сделало
сделат: сделать
себя: себя
сель: сельских
сельск: сельской
символ: символом
ситуаци: ситуации
сло: слоями
слов: слова
слоёв: слоёв
сначал: сначала
со: со
соб: собой
собр: собр
собран: собраниями
собрани: собраний
собрания: собрания
собраниях: собраниях
собственн: собственных
совет: советов, советских
советах: советах
советск: советской, советском
совещания: совещания
согласн: согласно
создавалис: создавались
созываться: созываться
сократит: сократить
соответстви: соответствии
соответствоват: соответствовать
соответствуя: соответствуя
соотношени: соотношении
составлял: составлял
сохранившейся: сохранившейся
социалистическ: социалистическом, социалистическому
социаль: социального
социальн: социально, социальным, социальными
социальны: социальные
соч: соч
спектр: спектр
специальны: специальные
список: список
способ: способы
способствовал: способствовало
способствуя: способствуя
сред: среди
средств: средство
срок: срок
ссср: ссср
стажировк: стажировку
стал: стал, стали
сталин: сталину
стандартизироваться: стандартизироваться
стары: старые
статус: статус
статья: статья
стенографич: стенографич
стран: страны
строительств: строительстве, строительству
строя: строя
существовани: существование
существования: существования
сферах: сферах
съезд: съезд, съезде
так: таких
таки: такие
таким: таким
тем: тем, темам
тенденция: тенденция
теоретическ: теоретической
теоретическу: теоретическую
тех: тех
тольк: только
том: тому
традиционн: традиционных
трех: трех
трудоустройств: трудоустройством
трудящихся: трудящихся
увеличени: увеличение
увеличивался: увеличивался
уезд: уездов
уже: уже
укрепил: укрепило
укрепит: укрепить
укреплен: укреплена
университет: университет, университета
управлени: управление, управлении
управления: управления
управленче: управленческих
управленческ: управленческой
управлят: управлять
упразднения: упразднения
уровн: уровне
уровнях: уровнях
ускорени: ускорению
услови: условием
условиях: условиях
установк: установками
установлени: установление
устаревш: устаревшей
усто: устои
уступил: уступили
утверждён: утверждён
утратил: утратили
уфа: уфа
участвоват: участвовать
участи: участие
участия: участия
участниц: участниц
учиться: учиться
учреждениях: учреждениях
фабриках: фабриках
феминизм: феминизм
феминистск: феминистского
форм: форма, формой, формы
формировалис: формировались
формировани: формировании
формироваться: формироваться
функц: функцией
функци: функции
хозяйственн: хозяйственному
цел: целом
цель: целью
центр: центр
цивилизационн: цивилизационным
цк: цк
част: часть
частност: частности
челябинск: челябинского
через: через
четырех: четырех
числ: число
что: что
шест: шести
широк: широкое
широки: широкий
школ: школу
экономик: экономике
экстремальн: экстремальных
элемент: элементами
эмансипаци: эмансипации
эмансипация: эмансипация
энтузиазм: энтузиазм
эпох: эпохи
эта: эта
этап: этапе
этапах: этапах
этих: этих
это: это
этог: этого
этом: этом
этот: этот
является: является
являлос: являлось
январ: январь
