аблов: аблова
август: августа
автограф: автографы
адрес: адресу
акад: акад
актив: актива
активист: активистом
активн: активно, активный
актуальн: актуальных
актуальност: актуальности
акци: акции
акция: акция
анализ: анализа, анализе
андр: андрей
аннотация: аннотация
апреля: апреля
апробирован: апробирована
археологиче: археологических
аспект: аспекта, аспектов, аспекты
аспирант: аспирант
аудитор: аудиторией, аудиторного
базов: базовых
бакалавриат: бакалавриата
бережн: бережное
берлин: берлин
бессонов: бессоновы
библиотек: библиотека, библиотеке
биограф: биографиями
биографи: биографии
биографиче: биографических
боев: боевого, боевых
боле: более
больш: большого, большой, большом
большинств: большинство
борис: борису
боях: боях
будуч: будучи
будуще: будущее
бум: бум
бурн: бурное
бывш: бывших
был: был, была, были, было
быстре: быстрее
быстрот: быстрота
бытов: бытовых
важн: важном
введен: введена
велик: великой
верн: верная
весенняя: весенняя
вестник: вестник
ветеран: ветеранов
вещественн: вещественных
взаимосвяз: взаимосвязей, взаимосвязь
вид: вид
викторин: викторины
вклад: вклад
включ: включая
включаются: включаются
включающ: включающая
включающи: включающие
включающу: включающую
власт: власти
влияни: влияние
влияния: влияния
внедрен: внедрены
внедрения: внедрения
внесш: внесших
внеурочн: внеурочных
внеурочны: внеурочные
внеучебн: внеучебной, внеучебных
внеш: внешней
внешни: внешний
внешност: внешность
внимани: внимание
военн: военная, военно, военной
воздвигнут: воздвигнуть
возложени: возложении
возможност: возможности, возможность
возраст: возрасте
воин: воинских, воинское, воину
войн: войны
волошин: волошиной
воплощени: воплощением
вопрос: вопрос, вопросами, вопросы
воспитани: воспитание
воспитания: воспитания
воспитанник: воспитанников
воспитательн: воспитательных
восстановлени: восстановлению
впоследстви: впоследствии
времен: времен, времена, времени
время: время
все: все
всег: всего
всегд: всегда
всероссий: всероссийское
всероссийск: всероссийского
всех: всех
вуз: вузов
выборн: выборной
выбранн: выбранном
вывод: вывод, выводам
выгодн: выгодно
выдающейся: выдающейся
выдающимися: выдающимися
выдающихся: выдающихся
выделим: выделим
выделяют: выделяют
выполнен: выполнены
выполнени: выполнении
выпускник: выпускникам, выпускников
высш: высшего, высших
выходящ: выходящих
выш: выше
выявлени: выявлению
вячеслав: вячеславу
газет: газеты
гак: гако
гарант: гарант
гаук: гаук
гб: гб
гбно: гбноу
гварди: гвардии
гг: гг
где: где
генетиче: генетический
геро: героев, герою
героизм: героизм, героизме
героя: героя
героям: героям
героях: героях
главн: главный, главными
глубок: глубокого, глубокому
го: го
год: года, годы
горазд: гораздо
гордост: гордости
город: города, городе, городов
городск: городского, городской, городском
городски: городские
городским: городским
горрайотделени: горрайотделений
государствен: государственного
государственн: государственная, государственный, государственных
государственност: государственности
государственны: государственные
готовност: готовности
граждан: гражданских
гражданск: гражданско, гражданского
гражданственност: гражданственности
гранит: гранит
групп: группы
губернатор: губернаторская
дав: давая
дале: далее
дальнейш: дальнейшем
дан: данного
данн: данном, данный
данны: данные
дат: дата
даёт: даёт
две: две
движения: движения
декабря: декабря
декрет: декрет, декрету, декреты
дел: дел, дела, дело
делегат: делегатов
демонстраци: демонстрации
департамент: департамент
дет: детей, дети
детск: детской
детям: детям
деятельност: деятельности
дзержинск: дзержинского
до: до
доброволь: добровольного
доклад: доклады
документ: документы
долг: долга
долерит: долерит
долженк: долженко
дом: доме
дополненн: дополненное
дополнитель: дополнительного
дополнительн: дополнительным, дополнительных
дополнительны: дополнительные
доск: доска, доскам, досками, доске, доски, доску
досках: досках
досок: досок
достижения: достижения
достопримечательн: достопримечательных
достопримечательност: достопримечательности
доступност: доступность
др: др
евгеньевн: евгеньевна
его: его
единичн: единично
ей: ей
елизавет: елизавета
емельян: емельянов
ещё: ещё
её: её
жизн: жизни
журнал: журнал
журналистах: журналистах
заведени: заведений
заведениях: заведениях
заведующи: заведующий
задани: заданий
задания: задания
задач: задач, задача, задачей
заканчив: заканчивая
закон: закон
закреплен: закреплено
закреплялас: закреплялась
занималис: занимались
занимают: занимают
заняти: занятий
запущен: запущен
заслугах: заслугах
защит: защите
звани: звание
здани: здании
здес: здесь
знак: знаком
знани: знаний
знания: знания
значени: значение
значим: значимое
значимост: значимость
зрител: зритель
иван: иванов
иванович: ивановичу
игор: игорю
игровы: игровые
из: из
известия: известия
известн: известных
извлеч: извлечь
изготовлени: изготовление
изготовления: изготовления
изд: изд
издатель: издательский
изменения: изменения
изображени: изображение
изображения: изображения
изучат: изучать
изучени: изучение, изучении, изучению
изучения: изучения
икц: икц
илларионович: илларионович
им: им
имел: имел
имен: имен, имени
импери: империи
имя: имя
индивидуаль: индивидуального
инструмент: инструментом
интегрируется: интегрируется
интерес: интересов, интересом
интернат: интернат
интерпретаци: интерпретации
интерпретация: интерпретация
информаци: информации, информацию
информационн: информационная, информационное, информационной, информационный
информационну: информационную
информация: информация
иным: иными
искусств: искусств
искусствовед: искусствоведы
исом: исом
исполнени: исполнение
использовалас: использовалась
использовани: использование, использовании
использования: использования
использоват: использовать
использоваться: использоваться
используются: используются
используя: используя
исправленн: исправленное
исследовани: исследовании, исследований, исследованию
исследования: исследования
исследовател: исследователи
исследователь: исследовательская, исследовательских
истор: историей
истори: истории, историю
историк: историко
историче: историческая, исторический, исторических, историческое
историческ: исторического, исторической, историческому
исторически: исторические
историческим: историческими
история: история
источник: источник, источника, источников, источником
их: их
июля: июля
июня: июня
кадет: кадетская
кадетск: кадетского
кажд: каждым
как: как
капитан: капитану
качеств: качестве
качественн: качественное
качественне: качественнее
квест: квеста, квесте, квесты
кевиш: кевишу
кемеров: кемерово, кемеровский
кемеровск: кемеровского, кемеровской
кемеровски: кемеровские
кл: кл
классификаци: классификации
классификация: классификация
классически: классические
ключев: ключевых
ключевы: ключевые
когд: когда
количеств: количества, количестве
ком: кому
команд: команд
комбинирует: комбинирует
комплекс: комплекс, комплексе, комплексу
конкретн: конкретным
конкретну: конкретную
конкурс: конкурсы
конкурсах: конкурсах
контекст: контекста
конференци: конференции
концепци: концепции
корпус: корпуса
котор: которого, которой, котором, который, которым, которых
которы: которые
краеведче: краеведческих
краеведческ: краеведческого, краеведческом
краеведчески: краеведческие
красн: красная
края: края
критери: критерию
кузбасс: кузбасс, кузбасса
кузбассовц: кузбассовцу
кулемзин: кулемзин
культур: культурного, культуры
культурн: культурно, культурное, культурной, культурных
культурны: культурные
курс: курс, курса, курсов
лаконичн: лаконичный
лейтенант: лейтенанту
ленинск: ленинскому
леон: леонов
лет: лет
лит: лит
литератур: литературы
литературн: литературных
личност: личностей, личности, личность, личностями
личностях: личностях
лиш: лишь
лучши: лучшие
люд: людей
май: май
мал: мало
малиш: малиш
маркер: маркером
март: март
мартын: мартынов
маршрут: маршрут, маршрута, маршруте, маршруты
масал: масалов
масалов: масалова, масалову
массов: массового, массовое
масштаб: масштаб, масштабе
материал: материала
материаль: материального
матушан: матушанский
машинописн: машинописный
мая: мая
мбо: мбоу
международн: международная
мемориал: мемориалов
мемориальн: мемориальная, мемориальной, мемориальному, мемориальный, мемориальным, мемориальными, мемориальных
мемориальну: мемориальную
мемориальны: мемориальные
мене: менее
мероприятия: мероприятия
мероприятиях: мероприятиях
мест: мест, места, место
метод: метод, метода, методы
методик: методика
методиче: методический
методическ: методического
миля: миляев
миляев: миляева
министерств: министерства
министр: министра, министров
митинг: митинг, митинге
мн: мн
мнени: мнению
могут: могут
модуля: модуля
можн: можно
молодеж: молодежи
монументальн: монументально
москв: москва
мрамор: мрамор
мраморн: мраморных
музе: музеев
музейн: музейный
музея: музея
муниципальн: муниципальным
мчс: мчс
мы: мы
набережн: набережная
наград: наград
над: над
написан: написана
направлени: направлении, направлений
народ: народа, народного
насибулин: насибулину
насибуллин: насибуллину
наследи: наследие
наследия: наследия
настоящи: настоящий
наук: науки
науч: науч
научн: научная, научно
научны: научные
нацелен: нацелена
наци: нации
национальн: национальная, национальной
начал: начали
начин: начиная
начинает: начинает
начинается: начинается
наш: нашей, нашему
некотор: некоторых
нем: нему
необходим: необходимо
необходимость: необходимостью
непрерыв: непрерывного
нескольк: нескольких, несколько
несут: несут
никола: николаю
них: них
нов: новыми
новы: новые
носят: носят
ноу: ноу
об: об
облагораживани: облагораживание, облагораживании, облагораживанию
облагораживания: облагораживания
обладает: обладает
областн: областной
образовани: образование, образовании
образования: образования
образователь: образовательного
образовательн: образовательной, образовательном, образовательных
обращения: обращения
обучающегося: обучающегося
обучающиеся: обучающиеся
обучающийся: обучающийся
обучающимися: обучающимися
обучающимся: обучающимся
обучающихся: обучающихся
обучени: обучение
общ: общего, общих
общеобразовательн: общеобразовательная, общеобразовательных
обществ: общества, обществе, общество
общественн: общественном
общност: общности
объект: объекта, объектами, объекте, объектов, объектом, объекты
объективн: объективной
объясня: объясняем
обязательн: обязательный
ограничивается: ограничивается
одн: одного, одной
одним: одним
ознакомления: ознакомления
округ: округов
октябр: октябрский
она: она
онюшев: онюшева
оп: оп
операция: операция
оперн: оперному
определенн: определенный
определяет: определяет
опыт: опыта
организаци: организации, организаций
организация: организация
организован: организована
орджоникидз: орджоникидзе
освободител: освободителю
освоени: освоении
осень: осенью
осмотр: осмотр
осмыслени: осмыслению
основ: основе, основы
основн: основная, основной, основными
основны: основные
особ: особого, особое
особенност: особенностей, особенности, особенностями
особенностям: особенностям
особенностях: особенностях
осознани: осознание
островск: островского
от: от
ответственност: ответственности
отвечают: отвечают
отдел: отдела, отделом
отделен: отделениями
отдельн: отдельный
отечеств: отечества
отечественн: отечественной
открыт: открыты
открыти: открытии, открытию
отличаем: отличаемой
отличившихся: отличившихся
отметит: отметить
отмечал: отмечали
относятся: относятся
отношени: отношение, отношении
отображается: отображается
отражают: отражают
отражени: отражением
отраженн: отраженной
отрыл: отрыли
отряд: отрядом
отчет: отчеты
отчетн: отчетно
охватывающи: охватывающий
охран: охрана, охране, охраны
ощущени: ощущение
памят: памяти, память
памятник: памятник, памятниками, памятники, памятников
памятниках: памятниках
парк: парке
пассивн: пассивный
патриотизм: патриотизма
патриотиче: патриотических, патриотическое
патриотическ: патриотического
пг: пг
певц: певцу
пед: пед
педагог: педагогом
перв: первой
передач: передачи
период: период, периода, периоды
пешеходн: пешеходная, пешеходном
пешеходну: пешеходную
письм: письмо
пк: пк
пласт: пласт
побуждени: побуждению
повышения: повышения
повышенн: повышенным
погибш: погибших
погибшим: погибшим
под: под
подвиг: подвигами
подлинн: подлинной
подлинник: подлинник
подобны: подобные
подпис: подписи
подрастающ: подрастающего
подчеркивают: подчеркивают
позволяющ: позволяющих
познавательн: познавательный
познани: познание
познат: познать
поиск: поиск, поиском
показ: показ, показа, показе
показывают: показывают
поколени: поколений
поколения: поколения
поколениям: поколениям
пол: пол
политик: политике
положени: положение
получения: получения
получил: получила
помещающихся: помещающихся
помим: помимо
помощ: помощи
помощь: помощью
попечителям: попечителям
популярн: популярной, популярных
попытк: попытку
пор: пор
портал: портал
портрет: портретов
поручени: поручению
посвящен: посвящена, посвящены
посвященн: посвященная, посвященный, посвященных
посвященну: посвященную
посвященны: посвященные
посещени: посещение
поскольк: поскольку
последни: последние
посмотр: посмотрев
пособи: пособие, пособии
постановлени: постановление, постановлений
постижения: постижения
потенциал: потенциал
потребност: потребности
поч: почему
появления: появления
появляется: появляется
пр: пр
правил: правило
правительств: правительства
практик: практик, практика, практике, практики
практиковалис: практиковались
практиковаться: практиковаться
предпринимает: предпринимает
предприяти: предприятие
представлени: представление
представления: представления
представляет: представляет
предусматривающ: предусматривающая
предшествует: предшествует
предыдущ: предыдущего
предыдущи: предыдущие
прежн: прежнему
президент: президента
преобладает: преобладает
преподавател: преподавателей
при: при
привлекается: привлекается
привлекалис: привлекались
привлекательность: привлекательностью
привлекаются: привлекаются
привлечени: привлечение
применения: применения
применяется: применяется
применялис: применялись
применят: применять
применяются: применяются
применяя: применяя
пример: примере
приняти: принятие
приобрел: приобрели
приоритетн: приоритетных
природ: природного, природы
природн: природное
присвоения: присвоения
присутствует: присутствует
притом: притомская
приходится: приходится
причин: причина
причинн: причинно
пришл: пришли
приём: приём, приёмами
проанализирован: проанализированы
проблем: проблемы
проведени: проведении
проведения: проведения
провел: провели
проводилас: проводилась
программ: программ
проект: проекта, проектом
происходил: происходили
происходящ: происходящему
пропаганд: пропаганды
просветитель: просветительский
просвещения: просвещения
проследит: проследить
прослушивани: прослушивании
просмотр: просмотр
протокол: протоколы
професси: профессий
проходящ: проходящем
процесс: процесса, процессе, процессу
прошл: прошлом, прошлому, прошлых
проявлен: проявлен
прям: прямой
путин: путина
пят: пяти
работ: работ, работа, работе, работы
работал: работал
раз: разного
развити: развитие
развития: развития
разговор: разговоры
различн: различных
размещалис: размещались
разн: разных
разработан: разработана
разработк: разработки
разряд: разряда
райков: райкова
район: районе, районного
районах: районах
рамк: рамки
рамках: рамках
раскрыти: раскрытии
расположен: расположена
расположени: расположение
расположенн: расположенных
распоряжени: распоряжение, распоряжению
рассказ: рассказа, рассказе
рассказчик: рассказчики
рассмотрет: рассмотреть
рассмотрим: рассмотрим
расстановк: расстановки
ргасп: ргаспи
рги: ргиа
реагироват: реагировать
реализуем: реализуемом
реализуется: реализуется
регион: региона, регионов
региональн: региональной, региональными
регулируются: регулируются
регуляр: регулярного
ред: ред
результат: результате, результатом
республик: республик, республики
ресурс: ресурс
род: родного
родин: родине, родину, родины
родственник: родственников
росси: россии
россий: российская
российск: российского, российской
рост: ростов
рсфср: рсфср
ру: ру
рус: русский
рф: рф
рысаев: рысаева
сайт: сайт
сам: самой, самом, самых
самостоятельны: самостоятельные
сб: сб
сведени: сведений
сведения: сведения
свидетельствующ: свидетельствующая
сво: сво, своего, своей, свои, свой, свою
своеобразн: своеобразным
своём: своём
связ: связи
связан: связанного, связаны
связанн: связанных
сделат: сделать
себ: себе
себя: себя
сегодня: сегодня
сентября: сентября
серия: серия
сибиряк: сибирякам
синхронизаци: синхронизации
сист: систему
систем: система, системе, системного
системн: системный
ситуаци: ситуации
сих: сих
скульптур: скульптур
следовал: следовало
следственн: следственной
следует: следует
следующи: следующие
следующим: следующим
следующу: следующую
слов: слова
сложившиеся: сложившиеся
сложилас: сложилась
сложность: сложностью
случа: случае, случаев, случаю
случаях: случаях
смотрящ: смотрящего
со: со
собрани: собрание
событ: событиями
событи: событие, событии, событий
события: события
совет: совета, советский, советских, советское
советск: советского, советской, советскому
современ: современного
современн: современной, современном
согласн: согласно
содержания: содержания
содержат: содержат
содержательну: содержательную
содержится: содержится
создания: создания
сокол: соколов
соответствующ: соответствующей
сопричастност: сопричастности
составлени: составлении
составляющ: составляющей
составляющу: составляющую
состоит: состоит
состоялся: состоялся
состояни: состояние
состоящ: состоящая
сохранени: сохранение, сохранению
сохранения: сохранения
сохраняют: сохраняют
социалистиче: социалистических
социальн: социальная
социальну: социальную
сочет: сочетая
союз: союза
спектр: спектр
сперанск: сперанского
специалист: специалист
специалитет: специалитета
специаль: специального
специальн: специальная
специальностям: специальностям
специальны: специальные
списк: списки
список: список
спорт: спорт
способ: способ, способов, способом, способы
способен: способен
способствует: способствует
сравнитель: сравнительного
сравнительн: сравнительный
средн: средне, среднего
средняя: средняя
ставится: ставится
стал: стала, стали
стандарт: стандартов
становится: становится
становятся: становятся
старин: старины
старш: старшему
стат: статей
статус: статуса
стать: статье
стилистик: стилистике
стоит: стоит
стран: стране, страны
стратеги: стратегии
стратегия: стратегия
студент: студентов
ступенях: ступенях
так: такой
таким: таким
тгу: тгу
текст: текст, текста, тексте
текстовы: текстовые
текущ: текущих
тем: тем, темой
тематическ: тематическому
территори: территории
территориальн: территориальному
территориях: территориях
теряют: теряют
тех: тех
технически: технические
тимофеевич: тимофеевичу
тольк: только
том: том
томск: томск
торжественн: торжественном, торжественному
традици: традиции, традиций
традиционн: традиционных
традиция: традиция
трансляци: трансляции
трансформация: трансформация
требованиям: требованиям
требует: требует
трепт: трептов
три: три
трудовы: трудовые
туризм: туризм, туризма
туристским: туристским
тяжин: тяжинская, тяжинский
тяжинск: тяжинской
увековечен: увековеченного
увековеченн: увековеченном, увековеченный, увековеченных
увековечив: увековечивая
увековечивания: увековечивания
увековечивают: увековечивают
увековечивающ: увековечивающая
увлекательны: увлекательные
уделяется: уделяется
уже: уже
украин: украины
ул: ул
улиц: улицам
улучшен: улучшено
университет: университет, университета
уникальн: уникальными
уникальност: уникальность
уникальну: уникальную
уничтожит: уничтожить
упоминается: упоминается
уровня: уровня
успешн: успешно
устанавливаться: устанавливаться
устанавливаются: устанавливаются
установк: установке, установки
установлен: установлена, установлено, установлены
установленн: установленная
установленны: установленные
утвержден: утверждена
уточнени: уточнению
участвовал: участвовали
участвуют: участвуют
участи: участие
участия: участия
участник: участника, участникам, участников
учащиеся: учащиеся
учебн: учебное, учебном, учебных
учебник: учебник
ученик: учеником
учениче: ученических
учитыват: учитывать
факт: факты
фгбо: фгбоу
федеральн: федеральных
федераци: федерации
федоров: федорова
филармони: филармонии
филармония: филармония
фонд: фонд, фонда
форм: форм, формам, форме, формой
формат: формат, формате
формировани: формирование, формировании
формирования: формирования
формирует: формирует
формируются: формируются
фронтах: фронтах
функци: функции
функция: функция
характер: характера
хронологиче: хронологический
хронологическ: хронологического
художественн: художественная
хх: хх
царск: царского
цвет: цветов
цдод: цдод
цел: целом, цель
цель: целью
целях: целях
ценн: ценный
ценност: ценности, ценность
центр: центр, центра
центральн: центральной, центральном
циркуляр: циркуляр
часть: частью
чащ: чаще
чгп: чгпу
человек: человека, человеке
через: через
черезов: черезова
четыр: четыре
числ: числе
член: члены
что: что
чувств: чувств, чувства, чувству
шеф: шефская
шефств: шефство
широки: широкий
школ: школ, школа
школь: школьного
школьн: школьный, школьных
школьны: школьные
штоколов: штоколова, штоколову
экскурсант: экскурсант, экскурсантам
экскурси: экскурсии, экскурсий, экскурсию
экскурсион: экскурсионного
экскурсионн: экскурсионное, экскурсионной, экскурсионном, экскурсионный
экскурсионны: экскурсионные
экскурсия: экскурсия
экскурсиях: экскурсиях
экскурсоведени: экскурсоведение
экскурсовод: экскурсовод, экскурсоводов, экскурсоводы
электронн: электронная, электронный
элемент: элемент, элементы
эстетическ: эстетической
этап: этапе
это: это
этом: этом
эту: эту
юны: юные
юных: юных
юрайт: юрайт
юрид: юрид
является: является
являются: являются
яковлев: яковлева
ярославл: ярославль
