август: августа
автор: авторы
администрац: администрацией
акцент: акцентом
алексеевн: алексеевна
альт: альта
анастасия: анастасия
аннотация: аннотация
апальк: апальков
архивн: архивной
архитектурн: архитектурное, архитектурном
белолипецк: белолипецкая
берег: берегу
благолепи: благолепие
больн: больному
борис: борис, бориса, борису
борисоглеб: борисоглебский
борисоглебск: борисоглебск, борисоглебска, борисоглебске, борисоглебской
борьб: борьба
бояр: боярами
брат: брата
братск: братской
брать: братьев
братьях: братьях
бревен: бревен
будет: будет
был: был, была, были, было, былое
важн: важным
варяг: варягов
вв: вв
век: века, веке
велик: великого
вер: веры
взор: взоров
включ: включая
владимир: владимир, владимира
власт: власть
влияни: влияние
вмест: вместе, вместо
внимани: внимание
возникш: возникшем
ворвалис: ворвались
ворон: вороны
воронеж: воронеж, воронежский
воронежск: воронежской
воспринят: воспринята
восходит: восходит
время: время
все: все, всей
всероссий: всероссийский
встреч: встречи
вторглис: вторглись
входн: входная
выдолбленн: выдолбленных
выждав: выждав
вызвал: вызвала
высоким: высоким
вышгород: вышгороде
гг: гг
где: где
глав: главе
главн: главным
глеб: глеб, глеба, глебу
глубоки: глубокие, глубокий
го: го
год: года, годов, году
голован: голованов
город: город, города, городе, городов
горожан: горожан
горясер: горясером
государств: государства
государственн: государственный
град: граде
грех: грех
гроб: гробу
групп: группа
двух: двух
ден: день
деревянн: деревянная, деревянном
детски: детские
деятел: деятелей
дизайн: дизайна
дискуссионн: дискуссионных
днепр: днепра
дня: дня
до: до
дождаться: дождаться
донын: доныне
доц: доц
дочер: дочери
дощат: дощатым
древ: древней
дружин: дружиной
духовн: духовно, духовное, духовным, духовных
духовност: духовности
духовны: духовные
евгеньевн: евгеньевна
его: его
ему: ему
епархи: епархии
желающи: желающие
жив: живого, живой
жизн: жизни, жизнь
жизнь: жизнью
жит: жить
забор: забором
завершит: завершить
закладк: закладки
заколол: закололи
закрыт: закрыт
заложен: заложены
замотал: замотали
захватил: захватил
захватит: захватить
захоронен: захоронен
защит: защиту
здани: здание
здания: здания
здес: здесь
знаменит: знаменитом
значени: значение
значительн: значительное
зон: зоны
зрител: зрителей
игровы: игровые
иде: идеи
из: из
известил: известил
известн: известно
икон: икона
имеет: имеет
имен: именем
именн: именно
именовался: именовался
интерактивн: интерактивной
интернет: интернет
искусств: искусства
истор: историей
истори: истории
историк: историко
исторически: исторические
их: их
июля: июля
как: как
каменн: каменный
канонизирован: канонизированы
кафедр: кафедры
киев: киев
кирпич: кирпичного, кирпичом
ключевы: ключевые
книг: книг
княз: князей, князь
князьям: князьям
князя: князя
колокольня: колокольня
комисси: комиссии
конц: конце
кончин: кончина, кончиной
копь: копьями
корн: корни
которы: которые
кра: край, краю
крепост: крепости, крепость
крестителя: крестителя
кром: кроме
кукольн: кукольными
культур: культура, культуре, культурного, культуры
культурн: культурное, культурным
купол: купол
лапин: лапина
летописн: летописным
литератур: литературы
любв: любви
люд: люди
ляжет: ляжет
материал: материалы
мая: мая
межд: между
мене: менее
мероприяти: мероприятий
мероприятия: мероприятия
мест: месте, местом
меч: мечом
микрофон: микрофон
мир: мире
митрополи: митрополии
молитв: молитвы
молод: молодой
момент: моменту
монастыр: монастыри
московск: московского
мощ: мощи
муром: муромом
мучениче: мученическая
мученическ: мученической
назван: названы
названи: название
наследи: наследие, наследии
наследия: наследия
наталия: наталия
наук: науки
научн: научный
начал: начал, началу
началас: началась
начат: начато, начаты
нашл: нашли
нее: нее
нек: некого
нем: нему
неразрывн: неразрывно
никак: никаких
нов: ново, нового, новый, новым
новопавловск: новопавловском
нравственн: нравственных
нужн: нужное
об: об
обезображенн: обезображенное
обнаружил: обнаружил
образ: образ
обществ: общества, обществе
одн: одно
одним: одним
оказал: оказал, оказали
окаянн: окаянный
окн: окна
он: он
она: она
они: они
освещает: освещает
осквернен: осквернен
основанн: основанный
оставил: оставили
остров: острове
от: от
отец: отец
отечеств: отечеству
открыт: открытой
открыти: открытие
относятся: относятся
отправил: отправил
отправился: отправился
отражен: отражены
отц: отца, отцу
павлов: павловская
павловск: павловской, павловском
паломничеств: паломничества
памят: памяти, память
памятник: памятник, памятника, памятнике, памятники
патриархат: патриархата
пени: пение
перв: первая, первым, первых
первы: первые
перед: перед
передают: передают
перенесен: перенесены
петр: петра
печенег: печенеги, печенегов
писател: писателями
письмен: письменного
площад: площадь
площадк: площадки
площадок: площадок
погиб: погиб
подвиг: подвигу
поддержк: поддержки
познакомит: познакомить
пок: пока
поколени: поколение
поколения: поколения
полотн: полотно
полоцк: полоцкого
получил: получил
пообещав: пообещав
посвященны: посвященные
посл: после
посланны: посланные
последующи: последующие
построен: построена
построенн: построенной, построенный
похоронил: похоронили
почитаем: почитаемых
почитани: почитание, почитанием, почитании
почитания: почитания
поэт: поэтами, поэтов, поэтому
правил: правил
православн: православная, православной
праздновани: празднованием
празднования: празднования
превращен: превращено
преддвери: преддверием
предложил: предложил
презентаци: презентации
престол: престол
прибыв: прибыв
приказал: приказал
прихожан: прихожан
проводится: проводится
проводятся: проводятся
прозаик: прозаиков
произведениях: произведениях
просветительски: просветительские
простоявш: простоявшая
прошл: прошло
псалм: псалмов
путш: путшу
работ: работа, работы
развернул: развернули
разграблен: разграблена
расположен: расположено
расположенн: расположенная
распространилос: распространилось
рассказывает: рассказывает
рассказывается: рассказывается
рассматриваются: рассматриваются
регулярн: регулярно
резонанс: резонанс
рек: рек, реки
религиозен: религиозен
реставрационны: реставрационные
ресурс: ресурс
решил: решили
рисунок: рисунок
рогволод: рогволода
рогнед: рогнеды
родн: родному
рождения: рождения
росси: россии
ростов: ростовом
руководител: руководитель
рус: руси, русских
русск: русского, русской
русски: русские
рф: рф
ряд: ряды
сам: самого
свидетельств: свидетельствам
сво: своему, своих
свободн: свободный
своим: своим
своё: своё
связан: связанного, связаны
связанны: связанные
свят: святым, святых
святополк: святополк, святополком
святославич: святославича
святы: святые
сгорел: сгорела
сентября: сентября
сердц: сердце
символ: символов, символом
склад: склад
скончался: скончался
слав: славу
след: след
слияни: слиянии
слияния: слияния
слов: слова
словес: словесного
словесност: словесности
слуг: слугой
смерт: смерти, смерть
смирения: смирения
смогл: смогли
снесен: снесены
со: со
событ: событиями
события: события
совпал: совпал
современн: современное, современном
согласи: согласии
согласн: согласно
создани: создание
сокрыт: сокрыто
соломенн: соломенном
сопровождавши: сопровождавшие
сопротивления: сопротивления
сосредоточен: сосредоточено
состоявшим: состоявшим
состоялос: состоялось
состоялся: состоялся
сохранени: сохранение
сохранившегося: сохранившегося
сохраняют: сохраняют
спат: спать
список: список
средств: средства
стал: стал, стали, стало
старейшим: старейшим
старособорн: старособорная
старши: старший
стать: статье
статья: статья
столиц: столицу
стоял: стояла
страстотерпц: страстотерпцам
стремяс: стремясь
строительств: строительство
стройматериал: стройматериалов
студент: студент
сцен: сцена
сын: сын
сыновь: сыновьями
так: таких
творчеств: творчества, творчеством
театр: театрами
тел: тело
тем: тем
территори: территорию
территория: территория
техниче: технический
тог: того
тольк: только
традици: традиции
традиционны: традиционные
тяжки: тяжкий
убийств: убийство
убийц: убийцы
убит: убит, убить
увезл: увезли
увеличит: увеличить
удел: удел
уже: уже
узнав: узнав
указ: указу
университет: университет
уничтожен: уничтожено
услышав: услышав
утвар: утварь
фестивал: фестиваль
фестиваля: фестиваля
филиал: филиал
формировани: формирование
хопр: хопра, хопре
храм: храм, храма, храме, храмом, храмы
цел: цель
ценност: ценностей
центр: центром
центральн: центральными
церкв: церкви
церков: церковь
церковн: церковная
церковь: церковью
часовня: часовня
чем: чем
чест: честь
читател: читателей
что: что
чьих: чьих
чья: чья
шатер: шатер
шатерн: шатерное
шатр: шатра
широки: широкий
этих: этих
этом: этом
этот: этот
являются: являются
ярмарочны: ярмарочные
