агитация: агитация
агрессивный: агрессивные, агрессивных
академия: академия
акимов: акимова
акт: актом
активный: активному
актуальный: актуальным
акция: акций
александр: александра
анализ: анализ
анатолиевич: анатольевна
базовый: базовые
баррикада: баррикадах
без: без
безопасность: безопасности
боевик: боевиков
боевой: боевую
боец: бойцов
бомба: бомб
борьба: борьбе, борьбы
будущее: будущем
быть: была, были, было
важно: важно
важный: важную
ввозиться: ввозилась
век: века
весь: весь
вещество: веществ
взгляд: взглядов
взрыв: взрывы
взрывчатый: взрывчатых
включать: включали, включало
включая: включая
власть: властей, власти, властям
возглавлять: возглавляемую
возникновение: возникновения
возникнуть: возник
вооружённый: вооруженных
восстание: восстание, восстании, восстания, восстаниям
время: времени
второй: вторая
вуз: вузов
вывод: вывод
вызвать: вызвали, вызвать
вызов: вызовы
вызывание: вызывании
выстрел: выстрелы
выступить: выступить
выявить: выявить
главный: главную
год: год, года
государственный: государственных
готовить: готовили
готовый: готовые
граница: границы
группа: групп, группу
движение: движения
действие: действий, действия
действовать: действовали
декабрь: декабря
демократ: демократов
демонстрация: демонстрациям
день: день
десяток: десятков
деятель: деятелей
деятельность: деятельность
длительность: длительностью
дмитриевич: дмитриевич
добиться: добиться
докладывать: докладывал
документ: документы
должный: должны
дом: дома
достигнуть: достичь
древность: древности
другой: другие
елена: елена
забастовка: забастовкам
забирать: забирают
завод: завода, заводе
заключаться: заключается
заключение: заключении
законный: законные
закупка: закупке
западный: западных
запретить: запрещенная
заставить: заставить
захватить: захватили
захватывать: захватывать
злобин: злобин
знание: знания
значительный: значительным
играть: играл, играли
идея: идей
из: из
изготовление: изготовлению
изд: изд
изменить: изменить
измениться: изменились
изменчивость: изменчивостью
изучение: изучение
иметь: имеет
император: императора
империя: империи
инспектор: инспектор
инструктор: инструкторов
инструмент: инструменты
исключительно: исключительно
использовать: использовали
исторический: исторического
история: историей, истории, история
как: как
канавино: канавино
картмаз: картмазов
кирилл: кирилл
класс: классов
ключевой: ключевые
князев: князев
когда: когда
козлов: козлов
количество: количество
комитет: комитет
конец: конце
контрабандный: контрабандным
корень: корни
который: которая, которое, которые, которых
крушение: крушение
кто: кто
лаборатория: лаборатории
либеральный: либеральных
лидер: лидерами
литейный: литейный
литература: литература, литературы
личность: личности
массовый: массовому, массовые
мастерская: мастерские
международный: международного
мера: мер, меры
местный: местным
место: места
метательный: метательного
метод: методами, методов
мирный: мирными
митинг: митингам
молодёжь: молодежи
мочалов: мочаловым
мощный: мощная
нападение: нападения
направляться: направлялись
например: например
народный: народные
население: населения
насчитывать: насчитывала
научный: научный
начало: начала, начало
начать: начали
начаться: началось
недостаток: недостатки
независимо: независимо
неизменный: неизменной
несколько: нескольких, несколько
нестабильный: нестабильной
неудачный: неудачные, неудачных
нижегородский: нижегородский, нижегородского
никитин: никитина
никон: никонов
оба: обе
область: области
огромный: огромные
один: одно
около: около
он: его
они: их, ним, ними, них, они
оперативный: оперативную
оправдать: оправдана
определённый: определенному
организация: организации
оружие: оружия
орёл: орёл
освободитель: освободителей
основание: основание
основываться: основывается
остаться: осталась
от: от
отлить: отлил
отличаться: отличается
отметить: отметить
отряд: отрядов, отряды
охрана: охраны
павел: павлом
паника: панику
партия: партии
паспорт: паспорта
переслать: перешли
перестрелка: перестрелки
период: периода
план: плану
повстанец: повстанцы
под: под
подготовка: подготовки
подобный: подобное, подобных
подпольный: подпольные
подразделение: подразделение
познакомиться: познакомиться
покушение: покушений
политический: политический, политических
половина: половина
помогать: помогает
понести: понесли
понять: понять
после: после
последующий: последующем
потеря: потери
предотвращение: предотвращению
предпринять: предприняты
представитель: представители
привести: привела
признавать: признавали
применение: применению
причина: причины
проблема: проблемы
проведение: проведении
провокатор: провокаторов
провоцировать: провоцировало
производить: производят
производство: производство, производству
происходить: происходили
пролетариат: пролетариата
пропаганда: пропаганда
против: против
прошлое: прошлого
прошлый: прошлых
прямо: прямо
публичный: публичные
путём: путем
пушка: пушки
работать: работающий
рабочий: рабочие, рабочих
развитие: развития
различный: различных
разный: разных
разработать: разработать
разрешение: разрешения
революция: революции, революция, революциях
режим: режим
роль: роль
российский: российской
россия: россии
рсдрп: рсдрп
руководитель: руководитель
руководство: руководством
русский: русских
рф: рф
с: со
самодельный: самодельные, самодельных
самый: самым
свет: свете
свобода: свободу
свой: своей, свои
сделать: сделать
сергей: сергея
силовой: силовых
система: системе
ситуация: ситуации
сколько: сколько
слабый: слабые
слово: слова, слово
служба: службы
слушатель: слушатель
снаряд: снаряды
собрать: собрать
событие: событий
совершить: совершено, совершены
согласно: согласно
создавать: создавать
создать: создали
сормово: сормово
соседний: соседнюю
сотрудник: сотрудник
социала: социал
социалистический: социалистических
социальный: социальную
специалист: специалистов
список: список
способ: способов, способы
способствовать: способствует
сражаться: сражался
среди: среди
сталь: сталь
стать: стало
столько: столько
сторона: стороне, стороны
страна: стран, страны
страх: страха
стремление: стремлении
стычка: стычки
сформировать: сформировано
сыграть: сыграла
такой: такое
теоретически: теоретически
территория: территорию
террор: террора, террору
терроризм: терроризм, терроризма
террорист: террористы
террористический: террористическим
течение: течением, течений
типография: типографии
только: только
тот: того, том, тому
траншея: траншее
убийство: убийства, убийство
удаться: удастся
удачный: удачные
удостоверение: удостоверения
умение: умение
уровень: уровней
усиление: усилению
устрашить: устрашить
участвовать: участвовали
участие: участие
участник: участники, участников
учебник: учебник
фабричный: фабричный
фальшивый: фальшивые
федеральный: федеральной
федерация: федерации
форма: форм, формы
химикат: химикатов
холодное: холодного
хотеться: хочется
хх: хх
царь: царя
целое: целом
цель: цель, целью
центр: центры
цех: цех, цехах
человек: человек
чертёж: чертежи
что: что
школа: школы
экстремистский: экстремистские
этнический: этнических
это: этим, это
этот: эта, эти, этих, этой
эффективный: эффективную, эффективные
явление: явлением
являться: является
