активно: активно
активный: активная
александр: александр
александрович: александрович
алматы: алматы
альтернативный: альтернативное
анализ: анализ
анастасия: анастасия
англ: англ
аннотация: аннотация
архивный: архивные
аспект: аспекты
ассортимент: ассортимента
атмосфера: атмосферу
аудиодорожка: аудиодорожки
аудитория: аудиторию
базироваться: базирующийся
банный: банно
библиография: библиографии
биография: биографии
благодаря: благодаря
более: более
больший: большую
будущий: будущих
быть: был, были
важный: важные
вдохновение: вдохновения
величко: величко
вершина: вершина
вестись: ведется
взаимодействие: взаимодействие
взаимодействовать: взаимодействует
виктор: виктора, виктору
викторович: викторовна
виртуальный: виртуальной, виртуальную
включать: включает, включают
включить: включенные
влиять: влияющих
внесубъектный: внесубъектной
возможность: возможность
вопрос: вопросы
воспроизвести: воспроизведены
время: времени, время
второй: второй
выбор: выбор
выдающийся: выдающихся
высокий: высокой
выступать: выступают
выступление: выступлений
выявить: выявлены
гвардеец: гвардейцев
где: где
гид: гида, гиды
главный: главной
глубокий: глубокий, глубокого
глубоко: глубоко
год: года, лет
голос: голосами
город: городе
готовиться: готовятся
грань: грани
громов: громов
далёкий: дальше
данный: данного, данном
дать: данной
два: два, двух
десяток: десятка
деятельность: деятельности, деятельность
диана: диана
дополнить: дополненную
доступность: доступности
друг: другом
женисбекович: женисбековна
жизнь: жизни
журнал: журнал
задача: задач
заключаться: заключается
закупать: закупает
запись: запись
зарегистрировать: зарегистрированными
звезда: звезда, звезды
здесь: здесь
знаменитый: знаменитые
значимый: значимым
игла: игла
идея: идеи
из: из
избыточность: избыточности
изображение: изображениями
изучение: изучение, изучения
иллюзия: иллюзии
имитировать: имитируют
иммерсивность: иммерсивности
иммерсивный: иммерсивной, иммерсивные, иммерсивных
имя: имени
инновационный: инновационные
интеллектуальный: интеллектуальных
интерактивность: интерактивности
интерактивный: интерактивные, интерактивных
интервью: интервью
интонация: интонации
искусственно: искусственно
искусство: искусства
использование: использование
исследование: исследовании, исследования
исторический: исторические
история: истории, историю
источник: источников
каждый: каждая
казахстан: казахстана
казахстанский: казахстанском
казимов: казимова
карта: карты
кафе: кафе
кафедра: кафедра
кинематограф: кинематографа
кинематографический: кинематографического
кино: кино
кинокартина: кинокартины
кинолента: киноленты
киносъёмка: киносъемки
ключевой: ключевые
когнитивный: когнитивному
комплекс: комплекс, комплекса
конструкт: конструктом
контекст: контекста, контексте
концепция: концепции, концепция
концерт: концерты
который: которая, которой, котором, которые
куда: куда
культовый: культовом
культурный: культурного, культурные
лежать: лежит
лектор: лектор
литература: литературы
личность: личностей
локализация: локализации
локация: локаций
магистр: магистр
максимальный: максимального
маршрут: маршрут, маршрута, маршруте
международный: международный
менять: менять
мероприятие: мероприятиям
место: мест, места, местами, месте
метод: метод
мечтать: мечтать
мир: мир, мире
можно: можно
монтаж: монтаж
москва: москва
мотивогенность: мотивогенности
мочь: может
музейный: музейными
музыка: музыки
музыкант: музыканта
наблюдаемость: наблюдаемости
навигация: навигации
назад: назад
назарбаев: назарбаева
написать: написаны
направление: направлении
народный: народное
наследие: наследия
настоящий: настоящее
насыщенность: насыщенности
наука: наук
научный: научный
находиться: находящегося
нейросеть: нейросети
немой: нем
необходимый: необходимый
николаев: николаев
новый: нового, новые, новый, новым, новых
нугмановый: нугманова
обзор: обзора
обладать: обладающим
область: областях
облик: облик
обогащать: обогащающих
оборудование: оборудование
образ: образом
образование: образование
обучать: обучающие
обученный: обученные
обход: обход
объект: объектами, объектов, объектом
один: одним
озвучка: озвучку
оздоровительный: оздоровительный
ознакомиться: ознакомиться
ознакомление: ознакомление
окружающий: окружающего
он: его, он
они: им, их, они
определение: определение
определить: определившего
определять: определяет, определяющих
оптимизация: оптимизации
опыт: опыт, опыту
оригинал: оригиналу
ориентация: ориентации
основа: основе
основательный: основательному
основной: основной
основный: основное
особенность: особенности
остановка: остановка
осуществляться: осуществляется, осуществляться
от: от
отбор: отбор
открывать: открывает
отражать: отражающим
отразить: отражено
оценить: оценить
ощущение: ощущений
памятник: памятник
панфилов: панфилова
панфиловец: панфиловцев
парк: парк
первый: первый, первых
передать: переданы
пережить: пережить
переосмысливать: переосмысливая
песня: песни
пластичность: пластичности
плёнка: пленке
погружаться: погружаться
погружение: погружение, погружения
подбор: подбор
подготовка: подготовка
поднимать: поднимая
поднять: поднявших
подобный: подобного, подобные, подобный, подобных
подобрать: подобраны
подход: подход
позволить: позволит
позволять: позволяет, позволяют
полный: полного
пользователь: пользователем
понимание: пониманию, понимания
понятие: понятие
понять: понять
популяризация: популяризации
портфель: портфеля
посвятить: посвящённой
посетить: посетить
пребывание: пребывания
предел: пределах
предлагать: предлагает, предлагая
предназначение: предназначение
предоставлять: предоставляет, предоставляя
предполагать: предполагает
представить: представлен
представлять: представляют
премьера: премьера
при: при
приближать: приближая
приближение: приближения
привлекаться: привлекаются
привлечь: привлечь
прикладной: прикладных
пример: примером
присутствие: присутствия
проводиться: проводятся
продукт: продуктом
продукция: продукции
проект: проект
проектирование: проектирования
произведение: произведения
происходить: происходило
пространственный: пространственной, пространственным
пространство: пространства, пространство
профессиональный: профессиональные
проходить: проходили
процесс: процесс, процессе
прочий: прочие
публика: публике
работа: работы
развиваться: развиваясь
развитие: развитии, развитию
различный: различные, различных
разнообразный: разнообразных
разработать: разработан
разработка: разработка, разработке, разработки
рамка: рамках
ранообразить: ранообразить
раскрывать: раскрывает
рассказ: рассказ
расширение: расширение
расширить: расширенную
рашид: рашида
реализация: реализации
реализоваться: реализуется
реальность: реальности, реальность
режиссёр: режиссёра
результат: результате
репрезентативность: репрезентативности
речь: речи
рк: рк
род: рода
руководитель: руководитель
рынок: рынка, рынке
самоорганизоваться: самоорганизующимся
сапрыкин: сапрыкин
свой: свою
свойство: свойства, свойствами
связанный: связанные
связать: связан
себя: себя, собой
сениор: сениор
сентябрь: сентября
сервис: сервис
сергеев: сергеев
сергеевич: сергеевна
символ: символом
систематизировать: систематизированный
системный: системным
следующий: следующие
слово: слова
смешанный: смешанную
событие: событий, событиях
современный: современном, современный
согласно: согласно
содействовать: содействующих
содержание: содержание
создавать: создающего
создание: создание, созданием, создании, созданию, создания
создать: созданном, созданные
соколов: соколова
солнце: солнце
сопровождать: сопровождающие
сосредоточить: сосредоточен
составление: составление
состояться: состоялась
софия: софия
сохранение: сохранению
спектакль: спектакль, спектакля
специфический: специфический
список: список
способствовать: способствовать, способствует
сравнить: сравнить
среда: сред, среды
стать: стать
студент: студент
субъект: субъекта
существующий: существующие
сценарий: сценария
сценарист: сценаристы
съёмка: съемкам, съемки, съемок
такой: таким, таких, такой
твой: твоя
творческий: творческие, творческой
творчество: творчества, творчество, творчеством
театрализация: театрализацией
текст: текста, тексте
тема: темы
теория: теории
технологический: технологической
технология: технологии, технологий
только: только
тот: того
точка: точка, точки
трансляция: трансляции
три: три
трёхмерный: трехмерного
туран: туран
туризм: туризм, туризме
туристский: туристского
уалиханов: уалиханова
удалять: удаляя
улица: улица
улучшение: улучшении
университет: университет
уникальный: уникальную, уникальный
уровень: уровень
успешный: успешной
устойчивый: устойчивых
устремление: устремлений
участие: участием, участии, участия
участник: участникам, участниками, участников
учёт: учетом
фактор: факторов
физически: физически
фильм: фильма, фильме
фокус: фокус
фокусироваться: фокусируется
форма: форм
формат: форматах
формирование: формирование
фото: фото
фотография: фотографии
фразеология: фразеология
характерный: характерные
ход: ходе
целостность: целостности
цель: цели
цой: цою, цоя
частичный: частичного
человек: человека
человечество: человечества
через: через
что: что
шаг: шаги, шагом
эволюция: эволюцию
экскрсия: экскрсий
экскурсионный: экскурсионного, экскурсионных
экскурсия: экскурсии, экскурсий, экскурсия
экскурсовод: экскурсовода
экспозиция: экспозициями
элемент: элементы
эмоционально: эмоционально
этап: этапы
это: этого, этом
этот: эти, этих, этот
эффект: эффект
эффективный: эффективных
являться: является, являются
