август: августа
авианосец: авианосцев
агрессивный: агрессивным, агрессивных
азиатский: азиатские
азия: азии
александр: александр
алексеевич: алексеевич
американский: американские
анализ: анализу
анализировать: анализируя
аннотация: аннотация
арена: арене
армия: армия
артур: артур
астахов: астахова
атомный: атомные
база: базу
без: без
бирма: бирма
битва: битва
благодаря: благодаря
блокада: блокада
богатство: богатства
более: более
больший: большей, большие, большую
большой: больше, большой
бомба: бомбами, бомбы
бомбардировка: бомбардировки
бомбардировщик: бомбардировщики
британский: британского
быть: будет, был, была, были, было, быть
важность: важности
важный: важных
вариант: варианты
ведь: ведь
век: век, века, веке
вектор: вектор
весь: всем
взять: взял
владение: владения
владивосток: владивосток
владивостокский: владивостокский
влияние: влияние, влиянием, влияния
вместо: вместо
военный: военно, военные, военных
возможный: возможном
война: войн, война, войне, войну, войны
войско: войск, войска
войти: вошел
воля: волю
восстановить: восстановлен
время: времен, время
всегда: всегда
всё: все, всё
второй: вторая, второй
выбрать: выбранную
вывод: вывод, выводом, выводу
выгода: выгоду
выиграть: выиграть
выйти: выйти, вышла
вытеснить: вытеснен
выявить: выявлены
где: где
генерал: генералы
главный: главную, главным
глобальный: глобальные
говорить: говорить
год: года, годов, году, годы
голландский: голландская
город: города, городам
господство: господству
государственный: государственный
государство: государством
гражданский: гражданского
гуадалканал: гуадалканал
дальнейший: дальнейшую
далёкий: дальше
дарья: дарья
дата: дата
дать: дал
два: две
действие: действий
декабрь: декабря
демократия: демократии
день: день
держава: державы
дефицит: дефицит
династия: династии
дипломатический: дипломатическую
до: до
доказать: доказала, доказало
должный: должны
донесение: донесением
дорога: дорогой
дорогой: дорогим
достаточный: достаточной
достаться: досталась
достигнуть: достигшие
досягаемость: досягаемости
доц: доц
друг: друг, другом
единственный: единственного
ещё: ещё
её: её
жестокий: жестокой
жизнь: жизней
житель: жителей
жёсткий: жесткая, жестких, жесткой
забрать: забрала
завершиться: завершилась
завоевание: завоевание
завоевать: завоеванных
зажигательный: зажигательными
закончиться: закончилась, закончились
закрепиться: закрепиться
закрытый: закрыт
занять: заняли
запас: запасы
заставить: заставило
значительный: значительной
идти: шло
из: из
избавиться: избавиться
известие: известия
изменение: изменение, изменения
изначально: изначально
именно: именно
император: император
императорский: императорского
индия: индия
институт: института
инфляция: инфляция
искать: искали
использование: использование, использования
использовать: использован, использованы
исторический: историческая, исторических
истощить: истощены
истый: ист
июль: июле
июнь: июне
казна: казна
как: как
канд: канд
капитуляция: капитуляции, капитуляцию
кафедра: кафедра
качество: качестве
квалификация: квалификацию
квантунский: квантунская
ким: ким
киото: киото
китай: китае
китайский: китайских, китайской
ключевой: ключевые, ключевых
когда: когда
конец: конце, концов, концу
конкурент: конкурента
контроль: контролем, контроль
конфликт: конфликта, конфликты
корабль: корабли
корея: корею
который: которая, которого, которое, которой, которому, которые, который
кроме: кроме
крупный: крупного, крупные, крупным
кто: кого
курс: курса
лидер: лидера, лидеры
литература: литературы
лишь: лишь
манила: манилу
маньчжурия: маньчжурией, маньчжурию
материальный: материальных
международный: международных
менять: менять
метод: методов, методы
мидуэй: мидуэй, мидуэя
милитаристический: милитаристическим
милитаристский: милитаристские
мирный: мирных
мировой: мировая, мировой
мнение: мнению
многий: многих
многогранный: многогранный
многое: многом
множество: множеством
можно: можно
морской: морские, морскую
мочь: могла, могли
мощь: мощи
мягкий: мягкая, мягкие, мягкой, мягкую
нагасаки: нагасаки
над: над
назвать: назвать
наиболее: наиболее
нападение: нападение
напасть: напала
народ: народа
население: населения
настолько: настолько
настоять: настоял
настроение: настроения
наука: наук
научный: научный
национальный: национальной
начало: начала, начале
начаться: началось
невозможно: невозможно
недавно: недавно
несмотря: несмотря
нести: несли
неутешительный: неутешительными
ни: ни
новость: новостей
новый: новые
нужно: нужно
оба: обе
обеспечить: обеспечить
обеспокоить: обеспокоены
обещать: обещали
обладать: обладает
оборона: оборона
обращение: обращения
обусловить: обусловлен
общий: общей
объявить: объявил
одержать: одержала
один: одной, одну
однако: однако
ожидать: ожидали
оказать: оказать
оказаться: оказались, оказалось, оказался
оказывать: оказывала
океан: океана
около: около
окончание: окончание, окончания
окончательно: окончательно
она: ей
они: они
оправдывать: оправдывают
опытный: опытных
ослабить: ослабили, ослабленная
основа: основе, основой
основной: основные
особенно: особенно
ост: ост
оставаться: оставались, оставаться
остаться: осталось
остров: остров, островов
от: от
отклонить: отклонила
отличие: отличие
отношение: отношений
отправной: отправной
отпугнуть: отпугнет
отчасти: отчасти
очень: очень
падение: падение
первый: первой, первые, первым
переговорный: переговорной
пересмотреть: пересмотреть
переход: переход, перехода, переходу
перл: перл
перспектива: перспективы
пилот: пилотов
план: плане
плохо: плохо
плохой: плохими
плюс: плюс
победа: побед, победа, победах, победу, победы
победитель: победителем
победительница: победительницей
повлиять: повлияют
повод: поводом
под: под
подводный: подводная
поддержка: поддержку
позволять: позволяет
поиск: поиска
политика: политика, политики, политику
политический: политических
полный: полному, полны
получаться: получалось
получить: получить
понести: понесли
понимать: понимая
понять: понять
поражение: поражение, поражении
поразительный: поразительной
порт: порт
посвятить: посвящена
после: после
последовать: последовать
последствие: последствии
последующий: последующей
послужить: послужили, послужило
поспособствовать: поспособствовали
потенциал: потенциал
потеря: потери
потерять: потеряла
потому: потому
потопить: потопил
потратить: потраченные
поэтому: поэтому
правительство: правительства, правительство
право: права, правах
практически: практически
превосходство: превосходство
предвещать: предвещая
предел: пределах
предлагать: предлагая
предложение: предложение
предпочитать: предпочитаемого
престиж: престижа
приблизить: приблизило
привести: привели, привело
приемлемый: приемлемой
пример: примером, примеры
принести: принесла, принесли, принесло
приносить: приносила, приносить
прислать: пришли
причина: причин, причины
проблема: проблемы
программа: программы
продовольствие: продовольствия
продолжать: продолжать
проиграть: проиграна
проигрыш: проигрыш
промышленный: промышленный
прорвать: прорвана
процесс: процесс
пустой: пуста
путь: пути, путь
пытаться: пыталось
работать: работают
развиваться: развиваться
разгром: разгрома
разрушение: разрушению, разрушения
разрушить: разрушены, разрушили
рангун: рангун
рассказывать: рассказывали
расти: растущая
реалия: реалиях
регион: региона, регионе
результат: результаты
ресурс: ресурс, ресурсов, ресурсы
решение: решение
решимость: решимости
решительный: решительную
роль: ролей, роли
российский: российского
россия: россии, россия
руководитель: руководитель
русский: русскую
русско: русско
рф: рф
с: со
сайпан: сайпана
самый: самых
свобода: свободу
свой: свое, своей, свои, свой, свою
связать: связанная
сделать: сделала, сделать
сделка: сделки
серия: серию
серьёзный: серьезные
сила: сил, сила, силе, силой, силу, силы
сильный: сильнее, силён
символический: символическое
сингапур: сингапур
ситуация: ситуацию
сказать: сказать
складываться: складывалось
сколько: сколько
скорость: скоростью
следующий: следующий
слишком: слишком
словно: словно
слово: слова
сложность: сложности
сложный: сложной, сложный
случай: случай
смена: смене, смены
сменить: сменить
смочь: смогла
собственный: собственной
событие: событие
советский: советский
современный: современных
согласиться: согласились
соломонов: соломоновых
соперник: соперник
сопротивление: сопротивление
состав: составе
сохранение: сохранения
сохранить: сохранила
социальный: социальных
союз: союз
союзник: союзники
список: список
старый: старой
стать: стал
статья: статья
степень: степени
стоить: стоила
столица: столицы
столкнуться: столкнулись
столько: столько
сторона: стороны
страна: страна, стране, страну, страны
стремиться: стремясь
стремление: стремление
студент: студент
суша: суше
считаться: считается
сша: сша
сыграть: сыграло
тайно: тайно
таки: таки
такой: таким, такого
там: там
тем: тем
территория: территорий
тихий: тихого
тихоокеанский: тихоокеанская, тихоокеанского, тихоокеанском
токио: токио
только: только
тот: того, тому, тот
тотально: тотально
тотальный: тотальное
точка: точкой
тревожный: тревожный
убирать: убирать
убито: убито
убыток: убытки
уважать: уважать
уважение: уважения
угрожать: угрожали
укрепить: укрепят
университет: университет
усиление: усиление
условие: условия, условиям
успех: успех
успешно: успешно
успешный: успешным
уступить: уступить
участие: участие
учитывать: учитывая
факт: факт
фактор: факторов, фактором
февраль: феврале
филиппина: филиппины
флот: флот, флота, флоту
фёдорович: федоровна
харбор: харбор
хиросима: хиросиме, хиросиму
ход: ходе
хороший: хорошее
хотя: хотя
хх: хх
цена: ценой
ценность: ценностей
цин: цин
часть: части
человек: человек
четыре: четырех
что: что
шанс: шанс, шансы
электронный: электронный
это: это, этого
этот: эта, этой, этот
эффективно: эффективно
южный: южной
являться: является, являлась
январь: январе
японец: японцев, японцы
япония: японией, японии, японию, япония
японо: японо
японский: японская, японские, японских, японского, японское, японской, японскому
яркий: яркие
ясный: ясен
