август: августа
алгоритм: алгоритм
алекс: алексей
алексея: алексея
аннотация: аннотация
аппарат: аппарата
аспирант: аспирант
байбак: байбаков
благодаря: благодаря
блокад: блокадного
бои: бои
боле: более
борьб: борьбой
был: был, была, были, было
вадим: вадим
велик: великая, великой
вернулся: вернулся
виктор: виктор
власт: властями
вмест: вместо
внук: внука
внутрипартийн: внутрипартийной
возможност: возможность
возникал: возникала
возращения: возращения
войн: война, войны
войск: войска
вооруженн: вооруженными
вопрос: вопросов, вопросом
восток: восток
восточноевропей: восточноевропейских
втор: второе, вторым
второстепенн: второстепенным
входил: входила
вывезен: вывезено, вывезены
вывоз: вывозе
выделит: выделить
выезжал: выезжал
выз: вызов
выявлен: выявлены
галицки: галицкий
гвишиан: гвишиани
гг: гг
гко: гко
главн: главной
год: год, года, годов, году, годы
город: город, городов
государственн: государственной, государственному, государственный
график: график
гришин: гришин
групп: групп, группы
гуманитарн: гуманитарный
данн: данное
два: два
декабря: декабря
ден: день
деятельност: деятельности, деятельность
диссертация: диссертация
дмитри: дмитрий
дня: дня
довери: доверие
доверил: доверил
доказат: доказать
должност: должности
должность: должностью
доложил: доложил
дополнительну: дополнительную
его: его
екатерин: екатерина
ему: ему
журнал: журнал
задания: задания
задач: задач, задача, задачами, задачей
заместител: заместителем
заместителя: заместителя
занимался: занимался
занял: занял
занялся: занялся
заняться: заняться
записк: записки
захватит: захватить
зон: зоны
из: из
имуществ: имущества
инициатив: инициативу
инспектировани: инспектирование
исследовани: исследований
исследуется: исследуется
историче: исторических
их: их
июля: июля
июня: июня
кадр: кадров, кадры
кандидат: кандидата
карьер: карьера, карьеры
карьерн: карьерный
кирпиченк: кирпиченко
ключевы: ключевые
когд: когда
количеств: количество
командирован: командирован
командовани: командованием
комисси: комиссии
комитет: комитет, комитета
контрол: контроль
конц: концу
координаци: координацию
косыгин: косыгин, косыгина, косыгину, косыгиным
котор: которая, который, которых
которы: которые
красноград: красноград
культур: культуры
культурн: культурных
кучков: кучково
легк: легкой
ленинград: ленинград, ленинграда
литератур: литературы
лиц: лиц
личн: лично
люд: людей
межд: между
мер: меры
мест: места, месте
местах: местах
местн: местными
млн: млн
мнения: мнения
можн: можно
мозохин: мозохин
молотов: молотову
москв: москва, москву, москвы
московск: московской
московску: московскую
навык: навыков
нагрузк: нагрузку
над: над
назват: назвать
назначен: назначен
накладывал: накладывало
налаживани: налаживание
направлени: направление, направлений, направлению
направления: направления
нарком: наркомам, наркомом
населения: населения
наук: наук
начал: начала, начале, начало
началас: началась
началис: начались
начальник: начальников
нег: него
некотор: некоторых
немецк: немецкой
немецки: немецкие
немц: немцам
необходим: необходимо
необходимост: необходимость
необходимы: необходимые
неудачн: неудачной
никола: николай
николаевич: николаевич, николаевича
нов: новом, новых
новы: новые
ноября: ноября
об: об
обком: обкомами
област: области, область
облисполком: облисполкомов
оборон: обороны
обороноспособност: обороноспособности
оборудования: оборудования
образован: образован, образованы
обстоятельствах: обстоятельствах
объект: объектов
объяснит: объяснить
обязанност: обязанностей, обязанность
одн: одной
однак: однако
одним: одним
оказавшихся: оказавшихся
оказывал: оказывал
оккупаци: оккупации
оккупировал: оккупировали
окол: около
октябр: октябре
октября: октября
он: он
оно: оно
оперативн: оперативная
оправдат: оправдать
организаторски: организаторские
организац: организацией
организаци: организации, организацию
организация: организация
основн: основной, основным, основных
основны: основные
осуществлени: осуществление
осуществлялас: осуществлялась
отечественн: отечественная, отечественной
относится: относится
отправил: отправил
павлович: павлович
парти: партии
перв: первое, первый
перед: перед
перечня: перечня
пищев: пищевой
план: планов
планировани: планированием
побед: победы
под: под
подбор: подбором
подготовит: подготовить
подготовк: подготовке
подлежащ: подлежащих
подобрат: подобрать
подтверждается: подтверждается
позволил: позволили
поиск: поиска
пол: поле
политик: политика
политиче: политическая
полос: полосы
помещени: помещений
помим: помимо
поручал: поручали
поручен: поручено
поручил: поручили
посл: после
пост: пост, посту
поставлен: поставлена
поставленн: поставленными
постановлени: постановление, постановлений
поток: потоков
предложения: предложения
предложил: предложил
предприяти: предприятий
председателя: председателя
представилас: представилась
представител: представителей
прекратил: прекратил
премьер: премьера
при: при
приближени: приближение
привел: привела
привлечен: привлечен
признан: признана
принял: принял
прифронтов: прифронтовой
проблем: проблемой
проверк: проверкой
продовольствия: продовольствия
проект: проектов
проинспектироват: проинспектировать
происхождени: происхождение
промышленност: промышленности
противник: противника
профессиональн: профессиональных
проявил: проявил
проявляя: проявляя
работ: работа, работе, работу, работы
работник: работниками
размещени: размещением
разработк: разработка, разработкой
райисполком: райисполкомов
район: районов, районы
ранни: ранний
распределения: распределения
рассмотрения: рассмотрения
республик: республик
решени: решение
решения: решения
россий: российский, российских
рост: рост
руководств: руководства, руководство, руководству
рф: рф
савченк: савченко
сам: самого
самостоятельн: самостоятельно
сво: своем, своих
связ: связь
связан: связано
связывался: связывался
сентября: сентября
сжаты: сжатые
сил: сил, силами
следит: следить
слов: слова
снк: снк
со: со
совет: совет, совета, совете, советом
совмещал: совмещал
совнарком: совнаркомов
современник: современников
содействи: содействие
создавалис: создавались
создан: создан
состав: составе
составлени: составлением, составлению
сотрудничал: сотрудничал
специалист: специалистов
список: список
способност: способности
справляться: справляться
срок: сроки
ссср: ссср
стал: стал, стала, стало
сталин: сталин, сталину
стать: статье
стран: страной, страны
стратегиче: стратегическое
стратегия: стратегия
стремительн: стремительный
структур: структуры
сырья: сырья
так: такой
текстильн: текстильной
тем: тем
тесн: тесно
тог: того
требовалос: требовалось
треть: третье
три: три
тыловы: тыловые
тысяч: тысяч
увеличилос: увеличилось
угроз: угрозой
удалос: удалось
удержаться: удержаться
уже: уже
укомплектовани: укомплектованию
укомплектоват: укомплектовать
укреплени: укреплению
университет: университет
уполномоченн: уполномоченным, уполномоченных
управлени: управлению
управленче: управленческих
успех: успех
успешн: успешно, успешной
утвердил: утвердил
утвержден: утверждено
участи: участии
феномен: феномен
фонд: фонд
фронт: фронтов
фронтов: фронтовой
харьк: харьков
харьков: харькова, харьковских
харьковск: харьковской
ход: ход, ходе, ходом
хотя: хотя
цель: целью
цен: ценного
ценност: ценностей
человек: человек
через: через
член: членами
чрезвычайн: чрезвычайных
что: что
эвакуац: эвакуацией
эвакуаци: эвакуации
эвакуационн: эвакуационных
эвакуация: эвакуация
эвакуирован: эвакуированы
эвакуированн: эвакуированных
эвакуироват: эвакуировать
этап: этап
этог: этого
этом: этом, этому
эффективност: эффективность
является: является
январ: январе
