аб: аб
абавязак: абавязак
абавязков: абавязкова
абл: абла
або: або
абрабавал: абрабавал
аг: аг
агнястрэльна: агнястрэльнай
агульна: агульнай
ад: ад
адбылася: адбылася
адбылося: адбылося
адз: адз
адзначалася: адзначалася
адзначаюц: адзначаюць
адказнасц: адказнасц
адм: адм
административн: административным
адн: адным
аднак: аднак
аднос: аднос
адпаведн: адпаведны
адсутнасц: адсутнасць
адукацы: адукацыю
аказал: аказал
акн: акно
акрамя: акрамя
акруг: акруг, акруга
акругов: акруговая
акт: акты
актыв: актыв
акуг: акуге
але: але
алкагол: алкаголю
алкагольн: алкагольных
альб: альбо
алькен: алькен
аляксея: аляксея
аннотация: аннотация
антыдзярж: антыдзяржа
апарат: апарат, апарата
аперат: аператы
аплачвалася: аплачвалася
апошня: апошняе
апрацаван: апрацаваных
аптэц: аптэцы
арган: арган
артыкул: артыкула, артыкулам
арх: арх
асаб: асаб
асабл: асабл
асабоваг: асабовага
асадн: асадн
асн: асно
асоб: асобы
асобн: асобна, асобны, асобных
асп: асп
атрым: атрыма
атрымл: атрымл
аф: аф
ахов: ахова, аховы
бак: баку
бакшт: бакшты
банд: банда
бандытызм: бандытызм
баранав: баранав
барацьб: барацьба, барацьбу, барацьбы
бгу: бгу
беднасц: беднасць
без: без
беззаганна: беззаганнае
белавежска: белавежскай
беларус: беларус, беларуси, беларусь
беларуска: беларускай
беластоцк: беластоцк
беластоцка: беластоцкай
беластоцкаг: беластоцкага
белорусси: белоруссии
белоруссия: белоруссия
бельск: бельск
беспрац: беспрацо
блахерович: блахеровича
бо: бо
бок: бок
болезн: болезнями
больш: больш
борьб: борьба, борьбе
брасл: брасла
брат: брата
брг: бргу
брест: брест
брэска: брэскай
бсг: бсг
бсср: бсср
будынк: будынка, будынкам
буйн: буйная
был: был, была, было
бюджет: бюджет
бяспек: бяспек, бяспеку
ва: ва
важныя: важныя
вайсков: вайсковых
вайскова: вайсковай
вал: вал
валас: валасо
валася: валася
ванн: ванне
вар: вары
варэння: варэння
ваходз: ваходз
вац: ваць
вацц: вацца
ваявод: ваяводы
ваяводск: ваяводск
ваяводска: ваяводскай
ваяводств: ваяводства, ваяводстве
ве: ве
велас: велас
вельм: вельм
верс: верс
внимани: внимание
вобласц: вобласц
войск: войска, войску
воложинск: воложинском
вольн: вольны
воп: воп
вопрос: вопросам, вопросы
воспоминаниях: воспоминаниях
воссоединени: воссоединение
ву: ву
вузкакалейна: вузкакалейнай
вул: вул
входил: входили
выб: выб
вываз: вываз
вывешан: вывешана, вывешаны
вывешвал: вывешвал
выглядз: выглядзе
выдавал: выдавал
выдач: выдача
выкан: выкана
выкарыст: выкарысто
выкарыстання: выкарыстання
выключн: выключна
выкрывалася: выкрывалася
выкрыл: выкрыла
выкрыццём: выкрыццём
вын: вын
выпадак: выпадак
выпадк: выпадк
выправ: выправ
выраб: вырабу
вырашал: вырашала
вырашан: вырашана
вырубк: вырубка, вырубку
высока: высокай
выязд: выязд
вял: вял, вяла
вярстах: вярстах
вяткавання: вяткавання
вёз: вёз
га: га
гад: гадо, гады
гадз: гадз
газет: газета
газец: газеце
гайн: гайна
гал: гало
гандлев: гандлевым
гандлева: гандлевай
ганн: ганна
гарадах: гарадах
гарадзенск: гарадзенск
гарадзенска: гарадзенскай
гарадзец: гарадзец
гарач: гарачым, гарачых
гарбарска: гарбарскае
гарбат: гарбаты
гародн: гародн
гаспадыня: гаспадыняй
гг: гг
генеральн: генеральны
герб: герб
гм: гм
гмин: гмин, гмины
год: год
годдзя: годдзя
годз: годзе
голас: голас
горад: горад
гос: гос
государств: государства
грамадзян: грамадзян, грамадзяне
грамадск: грамадска
грамадска: грамадскай
грамадств: грамадстве
грашов: грашовых
грашыл: грашыл
грашым: грашыма
гродзен: гродзенская
гродзенск: гродзенск
гродзенска: гродзенскай
гродзенскаг: гродзенскага
гродн: гродна
гродненск: гродненского
грош: грошы
груб: груб
грунт: грунто
груповак: груповак
грэбавал: грэбавал
гуляц: гуляць
гумов: гумовым
гуравал: гуравал
гуртк: гуртк
гэт: гэтым
гюльн: гюльню
да: да
дабрабыт: дабрабыту
даверана: даверанай
давол: давол
дадатков: дадаткова
дазвалялася: дазвалялася
дазвол: дазвол, дазвола
дайшл: дайшла
дал: дала
далося: далося
данясенн: данясенн
дапамога: дапамогай
дарэч: дарэчы
дасканальвалася: дасканальвалася
даследавал: даследавал
датычылася: датычылася
дацэнт: дацэнт
два: два
двал: двал
движени: движение
дзв: дзве
дзейн: дзейн
дзейнаг: дзейнага
дзейнасц: дзейнасц, дзейнасць, дзейнасцю
дзел: дзел, дзель
дзеля: дзеля
дзен: дзень
дзеянн: дзеянн
дзя: дзя
дзял: дзял
дзярж: дзяржа
дзяржав: дзяржаве
дзярэчын: дзярэчыне
добр: добра
документ: документы
дом: дома
донесени: донесение
др: др
дробн: дробных
дру: дру
друг: друг
дружын: дружыны
друк: друкам
друя: друя
дрэнна: дрэннае, дрэннай
дыверс: дыверс
дыяметр: дыяметрам
дэманстрант: дэманстранта
дэманстрац: дэманстрацый
дэманстрацыя: дэманстрацыя
ект: ектам
ены: ены
ер: ер
ерарх: ерарх
жа: жа
жанчын: жанчынам
жваенна: жваеннай
жигал: жигало
жн: жн
жыхар: жыхара, жыхаро, жыхары
жыцц: жыццю
заб: заба
забаран: забаран
забаранялася: забаранялася
забарон: забарона
забеспячэння: забеспячэння
забойств: забойствы
завалася: завалася
заван: заваная
заведзен: заведзена
завод: завода
загад: загада
задач: задач
займал: займал
займалася: займалася
заказчык: заказчыка
заканад: заканада
закл: закл
закон: закона
закончылася: закончылася
залезл: залезл
занальн: занальны
западн: западная, западной
заработн: заработная
зарвал: зарвал
затрымал: затрымала
затрыман: затрыманы
затрымац: затрымаць
зах: захо
заходня: заходняй
зац: зацы
зацыя: зацыя
зборн: зборн
збраенн: збраенне
зброен: зброеная
зброя: зброяй
зводк: зводк
зводках: зводках
звычайна: звычайнай
звярнулася: звярнулася
здар: здаро
здзяйснял: здзяйснял
здравствует: здравствует
землях: землях
зк: зк
зл: зл
зла: зла
злав: злав
злачынасц: злачынасцю
злачынств: злачынства, злачынствы
злачынц: злачынца
злодз: злодзем
злодзея: злодзея
злот: злотых
злучал: злучала
зм: зм
знайсц: знайсц
знайшл: знайшла
знак: знак, знака
знаходз: знаходз
знаёмств: знаёмства
зно: зно
знойдзен: знойдзена
зняволення: зняволення
зровен: зровень
зросц: зросце
зуб: зубо
зэльв: зэльве
зямл: зямл
изд: изд
йным: йным
ка: ка
кав: кавы
каг: кага
каз: каз
кайданк: кайданкам
кал: кал
калон: калона
каля: каля
кам: кам
камендант: каменданта, каменданту
камендатур: камендатур, камендатурам, камендатуры
камун: камун
кандыдат: кандыдат
кансперат: кансператы
кантакт: кантакты
кантрол: кантролем, кантроль
канф: канф
канфес: канфес
канцэнтрацыя: канцэнтрацыя
кап: кап
каров: каровы
каротк: каротк
карт: карты
карчм: карчме, карчмы
карыстацц: карыстацца
кастрычн: кастрычн
касян: касяно
кафедр: кафедры
кг: кг
клас: клас, класа
ключевы: ключевые
кмендант: кмендант
кодэкс: кодэкс
кожн: кожны, кожным
кол: кола
колас: колас
колькасн: колькасным
колькасц: колькасц
корпус: корпус
которы: которые
кошт: коштам
кпзб: кпзб
кра: кра
крадзеж: крадзежа
крадзежах: крадзежах
крадзяж: крадзяжо
крал: крал
крам: крама
крестьян: крестьянское
кризис: кризиса
крокас: крокаса
крым: крым
крын: крын
крэв: крэва
купал: купалы
купц: купцо
кур: кур
кушнер: кушнер
ла: ла
лад: лады
ладальн: ладальн
лактык: лактыка
ласнасц: ласнасц
лася: лася
ленска: ленскай
ленскаг: ленскага
лес: леса, лесам
лозунг: лозунгам
лцд: лцда
льн: льна, льным, льню
льня: льня
людзьм: людзьм
лютаг: лютага
лякарств: лякарства
лял: лял
лялася: лялася
ляльн: ляльных
лясн: лясным
лят: ляты
лёгк: лёгк
малад: маладая
маладзечн: маладзечна
малодш: малодшым
маральн: маральны
марк: марк
мас: мас
маст: маста, масты
мастах: мастах
материал: материалы
матэрыяльнаг: матэрыяльнага
мая: мая
маёнтк: маёнтка
маёр: маёр
ме: ме
медаля: медаля
межвоенн: межвоенный
мел: мела
меньш: меньш
мерапрыемствах: мерапрыемствах
местачк: местачко
местачков: местачковая, местачковым, местачковых
местечк: местечки
месц: месца
месяц: месяц, месяца
мец: мець
минск: минск
мкнул: мкнул
мкнучыся: мкнучыся
мн: мн
мноств: мноствам
мов: мове, мовы
мог: мог
монолитн: монолитный
мост: мост
моцна: моцнай
моцнаг: моцнага
мурах: мурах
мус: мус
мэта: мэтай
мя: мя
мяж: мяжу, мяжы
мян: мяна
мястэчак: мястэчак
мястэчк: мястэчка, мястэчку
мястэчках: мястэчках
мясцова: мясцовай
мясцоваг: мясцовага
мясцову: мясцовую
мясцовыя: мясцовыя
наарыклад: наарыклад
навагрудска: навагрудскай
навагрудскаг: навагрудскага
навана: наванай
нават: нават
наведванн: наведванне
наведвац: наведваць
навук: навук, навука
навуков: навуковых
наг: нага
нагенна: нагеннае
нагляд: нагляд
нагог: нагоге
над: надо
надзор: надзора
надк: надкам
надмерна: надмернае
надп: надп
нае: нае
нажал: нажаль
най: най
найбольш: найбольш
нак: нак
нал: нал
нальна: нальнай
нання: нання
напад: напад, напада
напал: напала
напо: напою
напоя: напоя
напружанасц: напружанасць
напрыклад: напрыклад
населеныя: населеныя
насельн: насельн
настр: настрой
наступн: наступных
насц: насцю
национальн: национальное
нацыянальн: нацыянальным
нашэння: нашэння
ная: ная
ндур: ндура
невядом: невядомы
невядомыя: невядомыя
ней: ней
некоторы: некоторые
нем: нема
несанкцыян: несанкцыян
неспадзяван: неспадзявана
нетакт: нетакто
нжынер: нжынер
нна: нна
нныя: нныя
нов: новая
ноч: ноч, ночы
ночч: ноччу
нск: нск
нспектар: нспектар
ну: ну
нула: нулае
нутран: нутраных
нутыя: нутыя
ную: ную
нфармавал: нфармавал
нфармацыя: нфармацыя
ншых: ншых
ны: ны
ным: ным
ных: ных
ныя: ныя
ня: ня
нягледзяч: нягледзячы
нядбальств: нядбальства
нядрэнн: нядрэнна
нязменн: нязменным
нёск: нёск
об: об
общественн: общественно
орган: органа, органам
организационн: организационно
освободительн: освободительное
освобождени: освобождение
особ: особое
па: па
пав: пав
паведамля: паведамля
павет: павета
паветах: паветах
павец: павеце
паводз: паводз
паводл: паводле
павял: павял
павятов: павятовая, павятовым, павятовых
павятоваг: павятовага
павятовам: павятоваму
павятовыя: павятовыя
павяторыя: павяторыя
паграж: пагража
пагражал: пагражала
пад: пад
падазронаг: падазронага
падворк: падворку
падк: падкам
падначален: падначаленым
падпалк: падпалко
падпарадк: падпарадко
падпаручн: падпаручн
падрабленн: падрабленне
падробк: падробкам
падрыхт: падрыхто
падтрыманн: падтрыманне
падтрымл: падтрымл
падчас: падчас
пажарныя: пажарныя
пазногця: пазногця
пазык: пазык
пак: пак
паказчык: паказчыка
пал: пал
палеска: палескай
палескаг: палескага
палк: палко
палов: палову
пан: пан
пар: пара
паравоз: паравоза
парадк: парадку
парт: партый
партрэт: партрэт
партызан: партызанам, партызаны
паручн: паручн
пасведчанн: пасведчанне
пасляваенныя: пасляваенныя
паст: паста
пастарунк: пастарунк, пастарунка, пастарунку
пастарункав: пастарункавы
пастарункавыя: пастарункавыя
пастерунк: пастерунка
пастэрунк: пастэрунк, пастэрунка, пастэрунку
пасёлк: пасёлка
патрабав: патрабава
патрабаванн: патрабаванн
паходжання: паходжання
пачалася: пачалася
пачастунк: пачастункам
пачаткова: пачатковай
пашпарт: пашпарто
пед: пед
пеня: пеня
пераважн: пераважна
перадав: перадав
перадал: перадал
пераклад: пераклад
пераслед: пераслед
переписк: переписка
период: период
першу: першую
першыя: першыя
песн: песн
плат: плата
пляц: пляцо
повет: повете, поветов
политическ: политическом
полицей: полицейских
полицейск: полицейского
полицейски: полицейские
полици: полиции
полиция: полиция
полуян: полуян
поль: польская
польз: пользу
польск: польск, польского, польску
польска: польскай
польскаг: польскага
польшч: польшчы
пот: потым
пошт: пошты
пра: пра
праблем: праблемам
прав: прав
правапарадк: правапарадку
правапарушэння: правапарушэння
правасл: правасла
праводз: праводз
прадпрыемств: прадпрыемства
прадпрыемствах: прадпрыемствах
прадугледжв: прадугледжва
прадукт: прадукта, прадукты
праз: праз
пракурорска: пракурорскай
праф: праф
прафес: прафес
праходз: праходз
прац: праца, працу, працы
працв: працв
працэсс: працэссе
прая: прая
продаж: продаж, продажу
прост: проста
пры: пры
прыватна: прыватнай
прыводз: прыводз
прынял: прынял
прыняцц: прыняццем
прыпынен: прыпынена
прыходз: прыходз
прыцягнут: прыцягнуты
прычына: прычынай
прэс: прэса
публ: публ
пункт: пункты
пушч: пушчы
пяц: пяц, пяць
ра: ра
раб: раба
рабоч: рабочая, рабочих
рав: рава
равання: равання
равану: раваную
раз: раз, разам, разо
разв: разв
разгал: разгал
рант: рант
рапарт: рапарт, рапарта
раск: раск
расп: распа
распараджэння: распараджэння
рассмотрен: рассмотрены
растралян: растраляны
рашэння: рашэння
революционн: революционное
рмаш: рмашу
ро: ро
ровар: ровара
розна: рознай
рунках: рунках
руска: рускай
рух: руху
рухалася: рухалася
рытас: рытас
рэал: рэал
рэв: рэв
рэвальвер: рэвальверам
рэвалюцыйныя: рэвалюцыйныя
рэгламентавал: рэгламентавал
рэгулявалася: рэгулявалася
рэдка: рэдкае
рэйк: рэйке
рэйск: рэйск
рэйска: рэйскае, рэйскай
рэйску: рэйскую
рэкамендав: рэкамендава
рэпутацыя: рэпутацыяй
рэспубл: рэспубл
рэстаран: рэстараны
рэч: рэчы
са: са
сал: сала
самагонаварэнн: самагонаварэннем
самагонаварэння: самагонаварэння
самагонк: самагонк, самагонку
самагонн: самагонны
самадзельн: самадзельны
самак: самак
сар: сар
сарыят: сарыяты
сацыялог: сацыялог
сацыяльну: сацыяльную
сачыл: сачыла
саюз: саюза
св: св
сва: сва
свая: свая
сваяк: сваяком
сваё: сваёй
сведчац: сведчаць
сведчыл: сведчыла
сво: свой
святочн: святочная
се: се
сед: седы
ск: ск
скавал: скавала
скаван: скавана
скаг: скага
скарб: скарбу
ская: ская
склад: склад, склада, складу
складал: складала
складз: складзе
скончылася: скончылася
скрадзен: скрадзена, скрадзены
скурак: скурак
слаб: слабая
слав: слава
следств: следства
следч: следчых
следчыя: следчыя
слов: слова
служб: службе, службы
служыл: служыла
сляд: слядам
слядах: слядах
см: см
смерт: смерть
снавал: снавала
снежня: снежня
современник: современников
сон: сон
сорокин: сорокин
состав: состав
состояни: состоянии, состоянию
социализм: социализм
социальн: социальное
соцыум: соцыум
спажыванн: спажыванне
спекулявал: спекулявал
спр: спр, спра
справ: справа, справы
справах: справах
спын: спын
спынення: спынення
спяв: спявая
сродк: сродка
ст: ст
ста: ста, стай
стам: стам
стан: стан, станов
старычн: старычных
старэйш: старэйшы
статыстыц: статыстыцы
стать: статье
стац: стаць
стварал: стварала
сто: сто
страйк: страйка
страц: страц
страцыя: страцыя
строг: строга
структур: структура
стст: стст
студзеня: студзеня
ступленн: ступленне
стычн: стычная
стычна: стычнай
стычныя: стычныя
стэм: стэма
стэрств: стэрству
субардынац: субардынацы
сувяз: сувяз
суд: суды
судова: судовай
сум: суму
супако: супакою
супрац: супрац
сустракалася: сустракалася
сутыкал: сутыкал
сцяг: сцяга
сы: сы
сюджана: сюджанае
сюджванн: сюджванне
ся: ся
сялян: сялянам
сярод: сярод
сярэдз: сярэдз
сярэдн: сярэдн
тавар: тавар, тавару
таварыств: таварыства
таког: такога
таксам: таксама
тал: тал, тала
талог: талог
тан: тан
таратур: таратура, таратуры
тацыя: тацыя
тбш: тбш
тое: тое
торг: торгу
тра: тра
тракц: тракце
транспарант: транспаранты
транспарт: транспарту
транспартнаг: транспартнага
транспарц: транспарц
траплял: траплял
трох: трох
трудящихся: трудящихся
тры: тры
трымал: трымал
трымл: трымл
туацыя: туацыяй
тур: тур
турм: турмы
турэмнаг: турэмнага
тыс: тыс
тычн: тычная, тычных
тычна: тычнай
тыя: тыя
тэрытарыяльнаг: тэрытарыяльнага
тэрытор: тэрыторы
тэрыторыя: тэрыторыя
тэт: тэт
тэхн: тэхн
угал: угало
уделяется: уделяется
удзел: удзелам
уезд: уезда
узарван: узарваны
узр: узро
улад: улады
умешвалася: умешвалася
ун: ун
унутрана: унутранай
управлени: управлением, управлений
управления: управления
урадав: урадавым
ус: ус
усю: усю
фальшыв: фальшывых
фальшываманетчык: фальшываманетчыкам
фасон: фасон
фашизм: фашизму
фон: фоне
фонд: фонд
форм: форму, формы
фронт: фронт
функц: функцы
фурманк: фурманку
хайл: хайл
хапал: хапала
харчавання: харчавання
хломк: хломка
храм: храма
хрысц: хрысц
хто: хто
хутк: хутка
хх: хх
ца: ца
цай: цай
цам: цам
царкв: царкву
цах: цах
цер: цер
цк: цк
цтв: цтва
цця: цця
цы: цы
цыган: цыган
цыйна: цыйнай
цыю: цыю
цыя: цыя, цыяй
ць: ць
цэйск: цэйск
цэйска: цэйскай
цэйскаг: цэйскага
цэнах: цэнах
цэнтральн: цэнтральны
цэр: цэра
цэск: цэск
цяжк: цяжк
цяжэ: цяжэй
цёк: цёкам
чал: чал, чала
чалавек: чалавек
чан: чаны
час: час, часам
частков: часткова
чатырох: чатырох
чвалася: чвалася
членск: членск
чнаг: чнага
чных: чных
чы: чы
чыгуначн: чыгуначны
чыгуначнаг: чыгуначнага
чыгунк: чыгунк
чым: чым
чын: чына, чыну
чырвон: чырвоных
чыт: чыта
чышчання: чышчання
чэрвен: чэрвень
шараг: шараго
шарагов: шараговы, шараговым, шараговых
шараговаг: шараговага
шаранг: шаранго
школ: школы
школьн: школьная
шл: шл
шла: шла
шлюб: шлюб
шмат: шмат
шматл: шматл
штатн: штатному
што: што
штогод: штогод
штодзен: штодзень
штомесяц: штомесяц
штомесячн: штомесячным
штост: штосты
штук: штук
шча: шча
шчучын: шчучынам
шчыльнасц: шчыльнасць
шыб: шыбу
шырока: шырокае
шых: шых
шэраг: шэраг
эк: эк
экан: эканам
экзэмпляр: экзэмпляра
экономическ: экономического
экспаз: экспаз
экспарт: экспарт, экспарту
эпидемическим: эпидемическими
эпох: эпох
этычн: этычны
юл: юл
яго: яго
яе: яе
язэп: язэпа
як: як
якая: якая
яког: якога
яком: якому
ям: ям
яму: яму
ян: ян
янк: янк
янств: янства, янствам
яныя: яныя
ёй: ёй
ёрах: ёрах
