агитация: агитация
агрессивн: агрессивных
агрессивны: агрессивные
академия: академия
акимов: акимова
акт: актом
активн: активному
актуальн: актуальным
акци: акций
александр: александра
анализ: анализ
анатольевн: анатольевна
базовы: базовые
баррикадах: баррикадах
без: без
безопасност: безопасности
боевик: боевиков
боеву: боевую
бойц: бойцов
бомб: бомб
борьб: борьбе, борьбы
будущ: будущем
был: была, были, было
важн: важно
важну: важную
ввозилас: ввозилась
век: века
вес: весь
веществ: веществ
взгляд: взглядов
взрыв: взрывы
взрывчат: взрывчатых
включ: включая
включал: включали, включало
власт: властей, власти
властям: властям
возглавляему: возглавляемую
возник: возник
возникновения: возникновения
вооруженн: вооруженных
восстани: восстание, восстании
восстания: восстания
восстаниям: восстаниям
времен: времени
втор: вторая
вуз: вузов
вывод: вывод
вызвал: вызвали
вызват: вызвать
вызов: вызовы
вызывани: вызывании
выстрел: выстрелы
выступит: выступить
выявит: выявить
главну: главную
год: год, года
государственн: государственных
готовил: готовили
готовы: готовые
границ: границы
групп: групп, группу
движения: движения
действи: действий
действия: действия
действовал: действовали
декабря: декабря
демократ: демократов
демонстрациям: демонстрациям
ден: день
десятк: десятков
деятел: деятелей
деятельност: деятельность
длительность: длительностью
дмитриевич: дмитриевич
добиться: добиться
докладывал: докладывал
документ: документы
должн: должны
дом: дома
достич: достичь
древност: древности
други: другие
его: его
елен: елена
забастовк: забастовкам
забирают: забирают
завод: завода, заводе
заключается: заключается
заключени: заключении
законны: законные
закупк: закупке
западн: западных
запрещенн: запрещенная
заставит: заставить
захватил: захватили
захватыват: захватывать
злобин: злобин
знания: знания
значительн: значительным
играл: играл, играли
иде: идей
из: из
изготовлени: изготовлению
изд: изд
изменилис: изменились
изменит: изменить
изменчивость: изменчивостью
изучени: изучение
имеет: имеет
император: императора
импери: империи
инспектор: инспектор
инструктор: инструкторов
инструмент: инструменты
исключительн: исключительно
использовал: использовали
истор: историей
истори: истории
историческ: исторического
история: история
их: их
как: как
канавин: канавино
картмаз: картмазов
кирилл: кирилл
класс: классов
ключевы: ключевые
княз: князев
когд: когда
козл: козлов
количеств: количество
комитет: комитет
контрабандн: контрабандным
конц: конце
корн: корни
котор: которая, которое, которых
которы: которые
крушени: крушение
кто: кто
лаборатори: лаборатории
либеральн: либеральных
лидер: лидерами
литейн: литейный
литератур: литература, литературы
личност: личности
массов: массовому
массовы: массовые
мастерски: мастерские
международ: международного
мер: мер, меры
мест: места
местн: местным
метатель: метательного
метод: методами, методов
мирн: мирными
митинг: митингам
молодеж: молодежи
мочалов: мочаловым
мощн: мощная
нападения: нападения
направлялис: направлялись
например: например
народны: народные
населения: населения
насчитывал: насчитывала
научн: научный
начал: начала, начали, начало
началос: началось
недостатк: недостатки
независим: независимо
неизменн: неизменной
нескольк: нескольких, несколько
нестабильн: нестабильной
неудачн: неудачных
неудачны: неудачные
нижегород: нижегородский
нижегородск: нижегородского
никитин: никитина
никон: никонов
ним: ним, ними
них: них
обе: обе
област: области
огромны: огромные
одн: одно
окол: около
они: они
оперативну: оперативную
оправдан: оправдана
определенн: определенному
организаци: организации
оружия: оружия
орёл: орёл
освободител: освободителей
основани: основание
основывается: основывается
осталас: осталась
от: от
отлил: отлил
отличается: отличается
отметит: отметить
отряд: отрядов, отряды
охран: охраны
павл: павлом
паник: панику
парти: партии
паспорт: паспорта
перестрелк: перестрелки
перешл: перешли
период: периода
план: плану
повстанц: повстанцы
под: под
подготовк: подготовки
подобн: подобное, подобных
подпольны: подпольные
подразделени: подразделение
познакомиться: познакомиться
покушени: покушений
политиче: политический, политических
половин: половина
помогает: помогает
понесл: понесли
понят: понять
посл: после
последующ: последующем
потер: потери
предотвращени: предотвращению
предпринят: предприняты
представител: представители
привел: привела
признавал: признавали
применени: применению
причин: причины
проблем: проблемы
проведени: проведении
провокатор: провокаторов
провоцировал: провоцировало
производств: производство, производству
производят: производят
происходил: происходили
пролетариат: пролетариата
пропаганд: пропаганда
против: против
прошл: прошлого, прошлых
прям: прямо
публичны: публичные
пут: путем
пушк: пушки
работающи: работающий
рабоч: рабочих
рабочи: рабочие
развития: развития
различн: различных
разн: разных
разработат: разработать
разрешения: разрешения
революци: революции
революция: революция
революциях: революциях
режим: режим
рол: роль
росси: россии
российск: российской
рсдрп: рсдрп
руководител: руководитель
руководств: руководством
рус: русских
рф: рф
сам: самым
самодельн: самодельных
самодельны: самодельные
свет: свете
сво: своей, свои
свобод: свободу
сделат: сделать
сергея: сергея
силов: силовых
систем: системе
ситуаци: ситуации
скольк: сколько
слабы: слабые
слов: слова, слово
служб: службы
слушател: слушатель
снаряд: снаряды
со: со
собрат: собрать
событи: событий
совершен: совершено, совершены
согласн: согласно
создават: создавать
создал: создали
сормов: сормово
соседню: соседнюю
сотрудник: сотрудник
социал: социал
социалистиче: социалистических
социальну: социальную
специалист: специалистов
список: список
способ: способов, способы
способствует: способствует
сражался: сражался
сред: среди
стал: стало, сталь
стольк: столько
сторон: стороне, стороны
стран: стран, страны
страх: страха
стремлени: стремлении
стычк: стычки
сформирован: сформировано
сыграл: сыграла
так: такое
теоретическ: теоретически
территори: территорию
террор: террора, террору
терроризм: терроризм, терроризма
террорист: террористы
террористическим: террористическим
течени: течением, течений
типографи: типографии
тог: того
тольк: только
том: том, тому
транше: траншее
убийств: убийства, убийство
удастся: удастся
удачны: удачные
удостоверения: удостоверения
умени: умение
уров: уровней
усилени: усилению
устрашит: устрашить
участвовал: участвовали
участи: участие
участник: участники, участников
учебник: учебник
фабричн: фабричный
фальшивы: фальшивые
федеральн: федеральной
федераци: федерации
форм: форм, формы
химикат: химикатов
холод: холодного
хочется: хочется
хх: хх
царя: царя
цел: целом, цель
цель: целью
центр: центры
цех: цех
цехах: цехах
человек: человек
чертеж: чертежи
что: что
школ: школы
экстремистски: экстремистские
эта: эта
эти: эти
этим: этим
этих: этих
этниче: этнических
это: это, этой
эффективну: эффективную
эффективны: эффективные
явлени: явлением
является: является
