абсолютн: абсолютное
автор: автором
актуальност: актуальность
алейск: алейск, алейского
алтай: алтайский
алтайск: алтайского
аналитиче: аналитический
аннотация: аннотация
аспирант: аспирант
барнаул: барнаул
безработиц: безработицы
бизнес: бизнес, бизнеса
будет: будет
бухвальд: бухвальд
бюджет: бюджетов
валентик: валентик
взаимосвяз: взаимосвязи
времен: времени
выполненн: выполненных
высоким: высоким
выявленн: выявленных
вэб: вэб
гг: гг
говоря: говоря
год: года, году
город: город, городов
городск: городского
государств: государству
государственн: государственная, государственной, государственный
градообразующ: градообразующих
данн: данной
дат: дата
действующ: действующих
ден: день
депутат: депутатов
десятилетия: десятилетия
деятельност: деятельность
динамик: динамика, динамику
до: до
доклад: доклад
дотаци: дотации
доход: доходов
жилищн: жилищно
задач: задач
заключается: заключается
занятост: занятости
заработн: заработная, заработной
зарегистрирован: зарегистрировано
зарегистрированн: зарегистрированной
заринск: заринск, заринского
зарубежн: зарубежным
из: из
икс: икси
импортозамещени: импортозамещению
инач: иначе
инвестици: инвестиций
инвестиционн: инвестиционной, инвестиционных
инвестиционну: инвестиционную
инвестор: инвесторам
индекс: индекс
индикатор: индикаторов
институт: институт
интерес: интереса
информация: информация
инфраструктур: инфраструктуры
исполнитель: исполнительного
исполнительн: исполнительный
использоват: использовать
исследования: исследования
историче: исторических
источник: источник
капитал: капитал
качеств: качеством
квалификаци: квалификации
ключев: ключевым
ключевы: ключевые
количеств: количества, количество
кольчугин: кольчугина
коммуналь: коммунального
коммунальн: коммунальной
комплекс: комплексного
координироват: координировать
котор: которая, которое, который, которых
края: края
круг: кругу
крупн: крупных
литератур: литературы
малы: малые
межд: между
мер: мер, меры
мест: мест
млн: млн
моногород: моногород, моногорода, моногородов
монопрофильн: монопрофильных
муниципаль: муниципального
муниципальн: муниципальных
наличи: наличие
налоговы: налоговые
направлени: направлении, направлений
направленност: направленности
населения: населения
научн: научных
начал: начале
начисленн: начисленная, начисленной
негативн: негативно
неготовност: неготовность
недостаток: недостаток
независим: независимым
необходим: необходимо
нерешенн: нерешенный
нехватк: нехватка
низки: низкий
никак: никакого
них: них
новоалтайск: новоалтайск
об: об
обзор: обзор
обладают: обладают
обозначит: обозначить
оборот: оборот
образовани: образований
образования: образования
обращения: обращения
обустройств: обустройства
объ: объем
объем: объемом
ограниченн: ограниченное
одн: одной
одним: одним
опережающ: опережающих
опережающи: опережающие
определени: определении
определения: определения
определенн: определенный
определит: определить
орган: орган, органов
организаци: организаций
организациям: организациям
основн: основной, основными, основных
основны: основные
особ: особого
особенност: особенностями
осуществляющ: осуществляющих
от: от
отгруженн: отгруженных
отечественн: отечественной
отклонени: отклонение
относящийся: относящийся
отражается: отражается
официальн: официально
парадокс: парадокс
педагогиче: педагогический
период: период
плат: плата, платы
под: под
поддержк: поддержка, поддержке, поддержки
позволит: позволит
позволяет: позволяет
показател: показатели, показатель
полн: полному
поняти: понятие
поселени: поселений
поселок: поселок
последн: последнего
правительств: правительства
предложения: предложения
предприяти: предприятий
представлен: представлен, представлена, представлены
представляет: представляет
преференци: преференции
при: при
привлекательност: привлекательности, привлекательность
приоритетн: приоритетных
прирост: прироста
присутстви: присутствие
пробл: проблем
проблем: проблемами, проблемы
прогноз: прогноз
программ: программа
проект: проектов
производств: производства
промежуток: промежуток
промышлен: промышленного
пространствен: пространственного
протяжени: протяжении
прям: прямо
работ: работ
работник: работников
рабоч: рабочих
развити: развитие, развитии
развития: развития
район: района
ран: ран
расположенны: расположенные
распоряжени: распоряжением
реализаци: реализации
реализация: реализация
регион: региона, регионы
региональ: регионального
региональн: региональный
ред: ред
резидент: резидентам
рекомендаци: рекомендаций
ресурс: ресурс
решени: решение, решением
рисунк: рисунке
рисунок: рисунок
розничн: розничной
росси: россии
россий: российских
российск: российской
росстат: росстат
руб: руб
рф: рф
ряд: рядом
сб: сб
своим: своими
связан: связано
сегодняшни: сегодняшний
сергеевн: сергеевна
сил: силами
ситуаци: ситуации
слаб: слабой
следстви: следствием
следующ: следующих
слов: слова
сложност: сложности
служб: служба
снижени: снижение
снижения: снижения
собрания: собрания
собствен: собственного
собственн: собственными, собственных
совершенствовани: совершенствование
современ: современного
современн: современных
создани: создание
соответствующи: соответствующие
составлен: составлено
состояния: состояния
сотрудник: сотрудников
социальн: социально, социальной
специфиче: специфических
список: список
способствоват: способствовать
средн: средних
среднемесячн: среднемесячная
среднесписочн: среднесписочная
средств: средств
стал: стало
стат: стат
статистик: статистики
статус: статуса
стать: статье
стратеги: стратегии
стратегическ: стратегического
стратегия: стратегия
структур: структуре
субсидировани: субсидированию
существенны: существенные
таблиц: таблице
татьян: татьяна
темп: темп
территори: территории, территорий
территориаль: территориального
товар: товаров
торговл: торговли
трудоспособ: трудоспособного
увеличит: увеличить
улучшени: улучшению
университет: университет
уровен: уровень
уровн: уровнем
услуг: услуг
установит: установить
устойчив: устойчивой
утвержден: утверждена
утверждени: утверждении
учреждени: учреждений
федераль: федерального
федеральн: федеральная, федеральный
федераци: федерации
финансирования: финансирования
фонд: фонд
функционирующим: функционирующими
характеристик: характеристике, характеристикой
целев: целевой
чел: чел
численност: численность
что: что
шипулин: шипулина
экономик: экономики
экономическ: экономического, экономической, экономическом
экономически: экономические
электронн: электронный
это: это, этой
этом: этом
является: является
являться: являться
являются: являются
