азбук: азбука
акт: акты
активн: активно
александрович: александрович
аналогичн: аналогичному
аннотация: аннотация
аппарат: аппарата
архив: архива
аспектах: аспектах
баз: базы
бес: бесами
библиороссик: библиороссика
бич: бич
благодаря: благодаря
богохульн: богохульных
боле: более
борьб: борьбы
брал: брал
бунин: бунина
был: была, были, было
быт: быть
бюрократическ: бюрократического
вв: вв
ввид: ввиду
ведовств: ведовство
ведомств: ведомства, ведомствами
ведьм: ведьм, ведьмами, ведьмы
век: века
веках: веках
вел: вели
величеств: величества
велос: велось
вид: вид, виде
видет: видеть
видн: видно
внимани: внимание
внимания: внимания
внутр: внутри
возможност: возможность
возраст: возрасте
вопрос: вопроса, вопросу, вопросы
вплот: вплоть
времен: времени
время: время
врод: вроде
вряд: вряд
все: все
всеволод: всеволод
всегд: всегда
всех: всех
встречается: встречается
выдержк: выдержки
вынесени: вынесении
выносилос: выносилось
выносился: выносился
вытекает: вытекает
выш: выше
выявления: выявления
выяснит: выяснить
гадани: гадание
гг: гг
георгиевич: георгиевич
главн: главной
горел: горелов
городах: городах
государев: государевы
государств: государств, государства
государствен: государственного
государственн: государственный
границ: границы
гримуар: гримуаров
групп: групп
даж: даже
дальнейш: дальнейшего
дан: данного
данн: данной
данны: данные
движен: движениями
действовавш: действовавшего
дел: дел, дела, делам, делами, дело, делу
делопроизводител: делопроизводителей
демон: демонами
демонах: демонах
денис: денис
детальн: детально
деяниях: деяниях
дифференцировани: дифференцирование
до: до
добавился: добавился
дознавател: дознавателей, дознаватели
дознания: дознания
документ: документов
документальн: документальный
документировани: документирование
допрос: допросов
доступн: доступной
доц: доц
дошел: дошел
древлехранилищ: древлехранилище
древняя: древняя
дьявол: дьяволом
европ: европе, европы
его: его
еди: единого
един: единый
елец: елец
елецки: елецкий
еретическим: еретическими
жанр: жанра
живописн: живописных
животн: животными
жител: жителей
заговор: заговоров, заговором
задействован: задействована
заимствования: заимствования
заимствованны: заимствованные
заключается: заключается
закон: законов
законодательны: законодательные
законодательств: законодательства, законодательство
заметит: заметить
занимал: занимало
занималос: занималось
занимался: занимался
запад: западе
западноевропей: западноевропейских
западноевропейск: западноевропейской
записок: записок
заподозренн: заподозренными
зачасту: зачастую
здес: здесь
зели: зелий
зна: знаем
знаком: знакомых
значени: значение
из: из
изб: избы
издательств: издательство
изучени: изучении
изучения: изучения
изъят: изъятых
им: им
имел: имел, имела, имели, имело
именн: именно
императорск: императорского
импери: империи
инач: иначе
инстанци: инстанции
инстанциях: инстанциях
интерес: интерес
информаци: информации
информация: информация
использовалис: использовались
использовани: использованию
исследовани: исследований
исследования: исследования
ист: ист
истори: истории
историк: историка, историко
историче: исторический
историческ: исторического
источник: источник, источника, источников
источниковедческ: источниковедческой
их: их
казалос: казалось
как: как, какое, какой
каки: какие
каков: каковы
канторович: канторович
канцеляри: канцелярии
касается: касается
католическ: католическо, католической
кафедр: кафедра
качеств: качестве
кивельсон: кивельсон
классик: классика
ключевы: ключевые
когд: когда
колдов: колдовских
колдовск: колдовской
колдовским: колдовским
колдовств: колдовства, колдовстве, колдовство, колдовству
колдун: колдуна
коллеги: коллегий
коллман: коллман
компаративн: компаративных
компаративны: компаративные
контактах: контактах
контекст: контексте
конц: конца, конце
концентраци: концентрацию
концептуальн: концептуальном
концепци: концепции, концепцию
корол: королев
котор: которая, которое, которых
которы: которые
культур: культуре, культурного
культурн: культурно, культурный, культурных
культурны: культурные
лавр: лавров
лежащи: лежащие
ленанд: ленанд
литератур: литературе, литературы
литературн: литературное
лиш: лишь
лишен: лишены
людьм: людьми
ляпин: ляпин
маги: магии
магиче: магических
магическ: магического
магически: магические
магия: магия
майер: майер
масс: массу
материал: материал, материалам, материалов, материалы
материальн: материальном
медиевистик: медиевистики
мемуар: мемуарного
мене: менее
мероприяти: мероприятий
мессах: мессах
мест: место
метод: методом
мож: можем
можн: можно
молот: молот
момент: момент
монография: монография
моральн: моральная
москов: московских
московск: московского
мы: мы
мысл: мысль
над: над
наиболе: наиболее
найт: найти
наказани: наказание
накладывал: накладывала
нам: нам
написани: написанию
направлени: направлению
направлялос: направлялось
например: например
нас: нас
наследия: наследия
наук: наук
научн: научный
начал: начал
некотор: некоторых
некоторы: некоторые
непосредственн: непосредственных
несомненн: несомненно
ни: ни
никак: никакого
ним: ним, ними
них: них
нов: нового, новое
новомберг: новомбергский
новоуказн: новоуказных
норм: нормы
ношени: ношению
ношения: ношения
обвиняем: обвиняемых
област: области
обнаружен: обнаружены
обозрени: обозрение
образ: образа, образом
обратиться: обратиться
обращалос: обращалось
обращени: обращением
обращения: обращения
общественн: общественном
обычн: обычным
оговор: оговоров
огульн: огульных
одержимост: одержимость
одн: одной
однак: однако
оказания: оказания
они: они
опиралис: опирались
описани: описаний
описанн: описанный
орган: орган, органов
организаци: организации
оргиче: оргических
ортодоксальн: ортодоксальной, ортодоксальному
орудия: орудия
освещени: освещение
основ: основе
основн: основном
особенност: особенность
от: от
отделения: отделения
отечественн: отечественной
отлажен: отлажено
отличи: отличие
отношени: отношении
отношения: отношения
отсутстви: отсутствии
отчаяния: отчаяния
отчет: отчеты
охот: охота
очевидн: очевидно
памятник: памятники
перв: первое
первостепенн: первостепенным
период: периода
периодическ: периодически
перспектив: перспективы
петр: петр, петра, петром
петров: петровских
печатня: печатня
подверженн: подверженных
поднималас: поднималась
подоб: подобного
подозреваем: подозреваемого
подробн: подробных
подробност: подробности
подробны: подробные
подряд: подряд
подход: подход, подхода, подходе
подходах: подходах
позволяет: позволяет
позволяют: позволяют
поздне: позднее
позици: позиций
поиск: поиска
показания: показания
пол: поле
полн: полное, полном
помощь: помощью
попадал: попадала
поправк: поправками
портрет: портрета
посвящен: посвящена
поскольк: поскольку
посл: после
послед: последней
посольск: посольского
потенциальн: потенциальный
почерпнут: почерпнуть
появляется: появляется
появлялис: появлялись
прав: права
правлени: правление
правов: правовом
православн: православная
практик: практике, практики
практическ: практически
практическим: практическим
предмет: предмет, предметом
предполагал: предполагал
представлен: представлен
представлени: представление
представляют: представляют
преображен: преображенский
преображенск: преображенского
преступлени: преступление, преступлений
преступления: преступления
при: при
приведенн: приведенных
привлечения: привлечения
приговор: приговор
приготовлени: приготовление
признани: признаний
приказ: приказ, приказа, приказе
приказн: приказной
приказны: приказные
применения: применения
принадлежност: принадлежности, принадлежность
приобщался: приобщался
присталь: пристального
проблем: проблемы
проведения: проведения
проводит: проводить
проникал: проникала
проникл: проникли
прорабатывал: прорабатывала
проследит: проследить
просопографиче: просопографических
просуществовавш: просуществовавшей
протестантск: протестантской
протокол: протоколов, протоколы
протоколах: протоколах
профессиональн: профессиональной
процесс: процессе, процессы
проч: прочего
прошедш: прошедших
прям: прямого
пыток: пыток
работ: работа, работе, работы
развивалас: развивалась
различн: различной, различных
различны: различные
разниц: разница, разницу, разницы
разнообразия: разнообразия
разнообразн: разнообразном, разнообразных
разнообразны: разнообразные
ране: ранее
ранн: раннего
расследован: расследованиями
расследовани: расследование, расследованием, расследованию
расследования: расследования
рассматривал: рассматривали
рассматриваются: рассматриваются
расспрос: расспросов
растени: растений
регулярн: регулярной
результат: результатом
результатах: результатах
религиозн: религиозной
религия: религия
реформ: реформ, реформу
решени: решение, решений
риск: риску
рол: роль
росси: россии
россий: российская
российск: российской
руководител: руководитель
руководств: руководств
рус: русское, русь
русск: русского
русски: русские
рф: рф
сам: само, самой, самом
сведения: сведения
сво: свое, свою
сводилас: сводилась
связ: связи
связанн: связанный, связанных
себ: себе
себя: себя
сегодня: сегодня
сил: силу
систем: системы
сказан: сказано
скрупулез: скрупулезного
следовател: следователей, следователи
следственн: следственными, следственных
следственны: следственные
следстви: следствий
следствия: следствия
слов: слова, слово
случаях: случаях
слушания: слушания
со: со
соб: собой
собор: соборного
собрани: собрание
собственн: собственно, собственной
совершения: совершения
содержани: содержание
содержат: содержат
содержательн: содержательный
создав: создавая
создани: создание
сознани: сознании
составит: составить
составления: составления
составлялис: составлялись
составлялос: составлялось
составляют: составляют
социаль: социального
социальн: социальной, социальном, социальных
сочинени: сочинение
сочинения: сочинения
спб: спб
сперан: сперанский
специализированн: специализированной
специфик: специфике, специфики, специфику
специфичн: специфичный
списат: списать
список: список
сравнив: сравнивая
сраз: сразу
сред: среди
средневековы: средневековые
стал: стало
сталкиваемся: сталкиваемся
старалис: старались
стат: статей
стать: статье, статьи
столетия: столетия
страницах: страницах
стрелецки: стрелецкий
студент: студент
судеб: судебного
судебн: судебный
судь: судьи
существовал: существовало
так: таки, таких, такого, такой
таким: таким, такими
там: там
текст: текст
тем: тем, тема, теме, теми, темой, темы
тематик: тематикой
теософ: теософская, теософских
теософск: теософской
тепер: теперь
тетрад: тетрадей, тетради
тех: тех
типография: типография
тогд: тогда
тож: тоже
том: том, тому
томск: томск
тот: тот
трактат: трактатов
трактатах: трактатах
требовал: требовали
трет: трети
тщательн: тщательно
увидет: увидеть
увидим: увидим
уделял: уделяла
уезд: уездов
уже: уже
уложения: уложения
университет: университет
упоминания: упоминания
управления: управления
уровн: уровне
усреднен: усредненного
устоявшегося: устоявшегося
участи: участии
учреждени: учреждение
ущерб: ущербе
факт: факт
фактор: фактор
феномен: феномен, феномена
фигурант: фигурантов
фиксаци: фиксации
фиксируя: фиксируя
форм: форм
формировани: формирование
формирования: формирования
ход: ходе
христианств: христианства
хроник: хроники
царств: царства
цель: целью
целях: целях
ценн: ценный
ценнейши: ценнейший
центр: центре
центральн: центральных
церкв: церкви
чар: чар
чародея: чародея
част: часто
чег: чего
что: что
шабашах: шабашах
шамин: шамин
шатк: шатков
экономик: экономика
эпистоляр: эпистолярного
эпох: эпох
эта: эта
эти: эти
этим: этим
это: это, этой
этог: этого
этом: этом
эту: эту
эффект: эффекта
юрайт: юрайт
явления: явления
является: является
яковлев: яковлева
