автореферат: автореферат
адаптироваться: адаптироваться
акимовн: акимовна
активн: активное
акушерск: акушерском
акушерску: акушерскую
александровн: александровна
ален: алена
андрюшин: андрюшина
анжелик: анжелика
апреля: апреля
арми: армии
армия: армия
баз: базе, базу, базы
без: без
безгранич: безграничного
белья: белья
благодарн: благодарным
благодаря: благодаря
боев: боевой, боевых
боле: более
больн: больными
больниц: больниц, больнице, больницы
больницах: больницах
больш: большое
большу: большую
боя: боя
брал: брали
бремя: бремя
бузулук: бузулук, бузулуке, бузулукская
бузулукск: бузулукском
бывш: бывшего
был: был, была, были, было
важен: важен
велик: великая, великой
велику: великую
вернулас: вернулась
вест: вести
ветеран: ветеран
вклад: вклад
включ: включая
владимир: владимир
влксм: влксм
вложил: вложили
вмест: вместе
внедрялис: внедрялись
внес: внес
внесен: внесены
внесл: внесли
внимани: внимание
внёс: внёс
воен: военного
военн: военно, военное, военным, военных
военны: военные
возвращалис: возвращались
возвращения: возвращения
возникл: возникла
войн: войн, война, войне, войны
вооруженн: вооруженными, вооруженных
восстановлени: восстановление
враг: врагом
врач: врачей, врачом
времен: времени
время: время
все: всей
всегд: всегда
вселял: вселяли
всем: всем
всех: всех
вся: вся
втор: вторая, второй
выезж: выезжая
выносил: выносили
выполнял: выполняли
выхаживал: выхаживали
где: где
герман: германией
гигиен: гигиене
гинекологическу: гинекологическую
главн: главным
глаз: глаза, глазного
глазн: глазном
го: го
год: год, года, годов, году, годы
город: города, городе
городск: городской
госпитал: госпитале, госпиталей, госпитали
госпитализация: госпитализация
госпитальн: госпитальной
госпитальну: госпитальную
госпиталях: госпиталях
государствен: государственного
гот: готов
готов: готовы
готовы: готовые
групп: группы
группах: группах
далек: далеко
дальнейш: дальнейшего
данн: данным
двенадцать: двенадцатью
двух: двух
девушк: девушка
девчонк: девчонку
дегтярев: дегтярева
действи: действий
действовал: действовало
декабря: декабря
дел: делу
демобилизаци: демобилизации
ден: день
дет: детей
деятельност: деятельность
диагностик: диагностики
директор: директор
дис: дис
дисциплин: дисциплинам
длительност: длительность
дни: дни
до: до
добилас: добилась
доктор: доктор
документ: документы
домохозяек: домохозяек
дорог: дорогами
доц: доц
друг: других, другого
други: другие
дух: дух
душаев: душаева
единствен: единственного
ее: ее
ей: ей
екатерин: екатерина
ест: есть
женщин: женщинам, женщины
жиз: жизней
жизн: жизни
жизнь: жизнью
заболевани: заболеваний
заболеваниям: заболеваниям
заболевш: заболевших
задач: задачей
закончит: закончить
занималис: занимались
запад: западе
запомнилис: запомнились
заслуженн: заслуженным
заслуживает: заслуживает
захвачен: захвачена
звезд: звезды
здравоохранения: здравоохранения
земл: земле
зимни: зимние
знамен: знамени
значени: значение
значительн: значительным
зон: зоне, зоны
из: из
изд: изд
изменения: изменения
изоляция: изоляция
им: им
имеющим: имеющим
ими: ими
инвалид: инвалид
институт: институт, институте
инструктор: инструкторов
инфекционн: инфекционный, инфекционным, инфекционных
ипк: ипк
ист: ист
истори: истории
исчезл: исчезли
итог: итоге
их: их
кадр: кадры
кажд: каждом, каждый
казахстан: казахстане
как: как
канд: канд
каникул: каникулы
канюк: канюков
категори: категории
кафедр: кафедра, кафедры
квалификаци: квалификации
квалифицированн: квалифицированных
клиническ: клинической
ключевы: ключевые
кн: кн
коек: коек
конфликт: конфликта, конфликтами
котор: которое
крас: красного
красн: красной, красный
крест: крест
кровопролитн: кровопролитным
крымск: крымском
кто: кто
кукушкин: кукушкина
курс: курса, курсы
кызыл: кызыл
лекарств: лекарств
лет: лет
летни: летние
летню: летнюю
лечебн: лечебный
лечени: лечение
лечения: лечения
лечил: лечили
литератур: литературы
лиш: лишь
лишениям: лишениям
люд: людей, люди
людски: людские
людях: людях
максимовн: максимовна
мария: мария
материал: материалов, материалы
материальн: материальных
медал: медали, медалями
медик: медики
медицин: медицинская, медицинский, медицинских
медицинск: медицинского, медицинской, медицинском
медицински: медицинские
медицинским: медицинским
медсестер: медсестер
медсестр: медсестры
местн: местных
месяц: месяца
методик: методики
микрохирургия: микрохирургия
миллиард: миллиардов
миллион: миллионов
минздрав: минздрава
мирн: мирно
миров: мировая
многи: многие
многочисленн: многочисленными
множеств: множество
мнтк: мнтк
мои: мои
молодёжн: молодёжной
мужественн: мужественно
награжден: награждена
над: над
надежд: надежду
нам: нам
населения: населения
настаивал: настаивала
настроени: настроение
насчитывалос: насчитывалось
наук: наук
научн: научный
начал: начала, начале
наш: наше
невероятн: невероятно
недел: недели, недель
недостаточн: недостаточной
ней: ней
ненормированн: ненормированным
неоценим: неоценимый
непрост: непростым
нескольк: несколько
несл: несли
нехватк: нехваткой
николаевн: николаевна
ним: ними
них: них
нов: новым
новейши: новейшие
нуждался: нуждался
об: об
обеспечен: обеспечена
област: области, областного, область
областн: областной
оборон: обороне
оборонительн: оборонительных
оборудовани: оборудование, оборудовании
обучен: обучены
обучени: обучение
обучения: обучения
общественн: общественных
общи: общий
огромн: огромный
одн: одного, одной
однак: однако
оказалис: оказались
оказани: оказании, оказанию
оказания: оказания
оказыв: оказывая
оказывал: оказывали, оказывало
окол: около
окончив: окончив
окулист: окулистов
она: она
они: они
оперативны: оперативные
операци: операции, операций
оперироват: оперировать
оперируя: оперируя
орд: орде
орден: ордена, орденом
оренбург: оренбург, оренбурга, оренбурге, оренбургская
оренбургск: оренбургского, оренбургской
оренбуржц: оренбуржцев
оренбуржь: оренбуржье
освобождени: освобождении
осен: осени
основн: основное, основной
особ: особое
особенн: особенно
остальны: остальные
остр: острая
от: от
отделени: отделении
отделения: отделения
отечеств: отечества
отечественн: отечественная, отечественной
открываться: открываться
отправилас: отправилась
отработал: отработала
отражавши: отражавшие
отрядах: отрядах
оценивалас: оценивалась
очерк: очерков
памят: память
партизан: партизанских
пациент: пациентов
пекл: пекле
перву: первую
первы: первые
перевозк: перевозкой
передов: передовой
перерыв: перерыва
пересмотрен: пересмотрены
период: период, периоды
периодическ: периодически
персонал: персонала
побед: победу, победы
повседневн: повседневной
погибл: погибли
под: под
подарк: подарки
подверг: подвергая
подвиг: подвиг, подвиге
подвижн: подвижных
подготовил: подготовила
подготовк: подготовки
подготовлен: подготовлено
поддерживал: поддерживали
поддержк: поддержку
поднимал: поднимали
подразделени: подразделении
поколени: поколение, поколением
пол: поле
полев: полевых
политик: политики
полмиллион: полмиллиона
полн: полным
половин: половина, половину
поля: поля
помещени: помещений
помог: помогая
помогал: помогали
помощ: помощи, помощь
пор: порой
порядк: порядка
посл: после
пострадал: пострадали
поступил: поступила
потапов: потапова
потерям: потерям
потомк: потомкам
потребност: потребность
почт: почти
пошив: пошиве
поэт: поэтому
появилис: появились
преданност: преданность
предприяти: предприятий
предупреждени: предупреждение, предупреждении
привел: привело
призван: призвана
признани: признание
признания: признания
принимал: принимала
принял: принял
приходилос: приходилось
пришлос: пришлось
проведени: проведении
проводил: проводили
проводилис: проводились
проводилос: проводилось
программ: программе, программу, программы
проделанн: проделанная
продолжал: продолжала
продолжил: продолжила
промышленн: промышленных
противовоздушн: противовоздушных
профессионализм: профессионализм, профессионализму
процедур: процедуры
прошл: прошли
работ: работа, работая, работы
работал: работала, работали
работат: работать
работах: работах
работник: работники, работников
рабочи: рабочий
рабочим: рабочими
рад: ради
развернут: развернуто
развития: развития
различн: различных
разн: разных
разработк: разработке
район: районе
ранен: раненым, ранеными, раненых
раненн: раненным
распоряжени: распоряжению
распространения: распространения
рассказ: рассказов
ратн: ратный
реабилитаци: реабилитацию
регион: регион
ремонт: ремонте
ресурс: ресурсов
решени: решению
рискуя: рискуя
родн: родной
родственник: родственники
рсфср: рсфср
рубл: рублей
руководител: руководителем, руководитель
руководств: руководством
рф: рф
рядовы: рядовые
сайгин: сайгин
сам: самого, самом, самым
самоотверженн: самоотверженно
самоотверженност: самоотверженности
санитар: санитаров
санитарк: санитаркой
санитарн: санитарной, санитарных
сборник: сборник
сведениям: сведениям
сво: своего, своей, своем, своему, свой
своевременн: своевременная
свыш: свыше
священну: священную
себя: себя
семь: семьей, семьями
сержант: сержанты
сестер: сестер
сестр: сестра, сестрой, сестры
сил: сил
симферопол: симферополе
сконцентрирован: сконцентрирована
следует: следует
слов: слова
сложн: сложный
сложны: сложные
служил: служила
со: со
совершал: совершал
совет: советский
советск: советского
современны: современные
согласн: согласно
создан: созданы
создани: создании
сократилас: сократилась
сократился: сократился
сокращен: сокращены
солдат: солдат, солдатам
составлявш: составлявших
составляет: составляет
составлял: составляли
сострадани: состраданию
сотен: сотен
сотрудник: сотрудники
сохранят: сохранять
союз: союза
спасал: спасали
спасат: спасать
спасени: спасение
спасения: спасения
специализированны: специализированные
специалист: специалистов
специалистах: специалистах
список: список
сражалис: сражались
сражени: сражений
сред: среди
средн: средних
ссср: ссср
стаж: стаж
стал: стала, стали
степановн: степановна
степен: степени
столкновени: столкновений
столкновения: столкновения
столкнулис: столкнулись
стр: строй
стран: стран, страны
стрик: стрике
студент: студент
суров: суровым
сутк: сутками
тактик: тактике
территори: территории
территория: территория
тех: тех
техник: техники
течени: течение
типография: типография
тог: того
тольк: только
том: том
трудилис: трудились
трудн: трудным
трудностям: трудностям
трудов: трудового, трудовой
трудящиеся: трудящиеся
трудящихся: трудящихся
тыл: тылу
тылов: тыловой, тыловых
тысяч: тысяч
тысячелетия: тысячелетия
тяжел: тяжелых
убит: убитых
уважения: уважения
увеличился: увеличился
угроз: угрозой
уделялос: уделялось
удостоен: удостоена
уезд: уезде
уйт: уйти
украинск: украинского
умнож: умножая
унесшим: унесшими
университет: университета
уник: уник
урал: урал, урала, урале
уровнях: уровнях
условиям: условиям
условиях: условиях
утешени: утешение
ухаживал: ухаживали
уход: уходу
участвовал: участвовали
участи: участие, участии
учебн: учебный
ученик: учеников
училас: училась
учреждения: учреждения
учреждениях: учреждениях
ушл: ушла
факультет: факультет
фельдшерск: фельдшерско, фельдшерском
филиал: филиала
фронт: фронт, фронта, фронту
фронтах: фронтах
функционировани: функционировании
хвостов: хвостова
хирург: хирургом
хирурги: хирургии
хирургическ: хирургической
хотел: хотела
цель: целью
цк: цк
част: часто
человек: человек
человече: человеческих
человечеств: человечеству
челябинск: челябинск
четырёх: четырёх
числ: числе, число
чкалов: чкалове, чкаловская, чкаловский
чкаловск: чкаловской
что: что
школ: школу
эвакогоспитал: эвакогоспитале, эвакогоспитали
эвакогоспиталя: эвакогоспиталя
эвакуац: эвакуацией
эвакуаци: эвакуации
экстренну: экстренную
энциклопедиче: энциклопедический
эпидемиологиче: эпидемиологических
эпидемиче: эпидемических
эсфир: эсфирь
эта: эта
эти: эти
этих: этих
это: этой
этог: этого
этот: этот
юж: юж
южн: южного, южном, южный
является: является
