автор: автора
академиче: академическая
активн: активно
актуальны: актуальные
анатольевич: анатольевич
аннотация: аннотация
бажин: бажин
безграничн: безграничных
бездым: бездымного
библиотек: библиотека
биография: биография
боле: более
был: был
важн: важной
важнейшим: важнейшим
вернувшис: вернувшись
вех: вехой
вклад: вклад, вкладом
включ: включая
владимировн: владимировна
влияни: влияние
внимани: внимание
воздухоплавани: воздухоплавание
возможностях: возможностях
вопрос: вопросами
выдающегося: выдающегося
где: где
геология: геология
гимнази: гимназии
глав: главного
главн: главному
год: года, году
годах: годах
горн: горный
горьк: горького
государственн: государственный
дальнейш: дальнейших
дат: дата
демидовск: демидовской
деятельност: деятельности, деятельность
диссертация: диссертация
дмитри: дмитрий
дмитрия: дмитрия
дня: дня
до: до
достижени: достижением
друг: других
его: его
естествознани: естествознание
жизн: жизни, жизнь
журнал: журнал
закон: закон, закона, закону
заложил: заложила, заложило
занимался: занимался
зарубежн: зарубежной
знамениты: знаменитые
знани: знаний
значим: значимым
значительн: значительное, значительной
иванович: иванович, ивановича
из: из
изобретени: изобретение
изоморфизм: изоморфизма
изучени: изучением
им: им
имен: именем
институт: института
исполнилос: исполнилось
исследовани: исследований
исследования: исследования
исследуются: исследуются
история: история
как: как
капитальн: капитальным
карьер: карьера
ключев: ключевым
ключевы: ключевые
командировк: командировки
котов: котова
котор: которая, которое, который
критическ: критической
крупн: крупное
лет: лет
литератур: литературы
магистрант: магистрант
математиче: математический
менделе: менделеев
менделеев: менделеева
метеорологи: метеорологию
метеорология: метеорология
метрологи: метрологию
миров: мировой, мировом, мировым
многогранност: многогранность
написав: написав
наследи: наследие
наук: наук, наука, науки
научн: научная, научное, научной, научный, научных
научны: научные
началас: началась
нефт: нефти
нефтян: нефтяной
областях: областях
обращения: обращения
общественн: общественной
оказал: оказали
он: он
органическ: органической
осн: основ
основ: основой, основы
основополагающим: основополагающим
особ: особое
оставаться: оставаться
осуществленн: осуществленное
от: от
открыти: открытие, открытию
открытия: открытия
отрасл: отраслей
педагогиче: педагогический
педагогическ: педагогического
педагогическу: педагогическую
перв: первое, первой, первый
перегонк: перегонки
период: период
периодиче: периодическая, периодический
периодическ: периодического, периодической, периодическому
петербург: петербург, петербургский
петербургским: петербургским
подкрепленн: подкрепленное
подчеркивает: подчеркивает
поняти: понятием
порох: пороха
поступления: поступления
преми: премии
преподавал: преподавал
привел: привела
признанн: признанным
прикладн: прикладными
принцип: принципы
провел: провел
прогресс: прогресс
продолжает: продолжает
продолжени: продолжение
продолжил: продолжил
производительн: производительных
промышленн: промышленный
промышленност: промышленности
профил: профиль
работ: работой
развити: развитие, развитию
различн: различных
разработк: разработки
разум: разума
рассматривается: рассматривается
раствор: растворов
регионоведени: регионоведение
ресурс: ресурс
рождения: рождения
рол: роль
росси: россии, россию
россий: российская, российский
российск: российской
русск: русского
рф: рф
ряд: ряда
санкт: санкт
свидетельствует: свидетельствует
сво: свои, свою
своё: своё
связан: связан, связанного
связанн: связанное
сделал: сделал
сегодня: сегодня
сель: сельское
сибир: сибирский
сил: сил
систем: системы
слов: слова
со: со
современн: современной
создал: создал
создани: создании, созданию
создания: создания
сообществ: сообщество
список: список
способ: способ
способствовал: способствовали
спустя: спустя
стал: стал, стала, стало
стать: статье
статья: статья
сусл: суслов
сцепления: сцепления
сяою: сяоюй
таблиц: таблица, таблицы
так: таких
таки: такие
талант: таланта
тем: тему
температур: температуры
теория: теория
тесн: тесно
техник: техники
течени: течение
тольк: только
труд: трудов, трудом
уделен: уделено
удостоен: удостоен
универсант: универсанты
университет: университет, университетом
уровн: уровне
участвовал: участвовал
уче: ученого
учебник: учебник
учителя: учителя
факультет: факультет
февраля: февраля
физик: физика, физико, физику
фракционн: фракционной
фундаментальны: фундаментальные
хими: химии, химию
химиче: химический, химических
хозяйств: хозяйство
цикл: цикла
частиц: частиц
частност: частности
человеческ: человеческого
чжан: чжан
экономик: экономику
электронн: электронный
элемент: элементов
энциклопедист: энциклопедиста
это: это
