автор: автор
аграрный: аграрного
агропромышленный: агропромышленный
адаптироваться: адаптировались, адаптируясь
академия: академия
активизироваться: активизировался
активно: активно
анализировать: анализирует
база: баз, база, базу, базы
бурмистров: бурмистров
быстро: быстро
быстрый: быстрым
быть: были, было
важный: важную, важным
васильев: васильев
век: века
весь: всего
взаимодействие: взаимодействие
видеоматериал: видеоматериалов
включать: включало
владимирович: владимировна
влияние: влияние
вложение: вложения
внедрение: внедрение, внедрения
внимание: внимание
востребовать: востребованных
время: время
вывод: выводов
вызов: вызовы
выполнять: выполняли
выпускник: выпускники, выпускников
выражаться: выражалось
высокий: высокого, высокой
главный: главных
год: гг, годов
государственный: государственная, государственного, государственные, государственный
государство: государства, государство
готовить: готовить
груздев: груздев
дать: данная
дисциплина: дисциплины
дмитриев: дмитриев
до: до
достигнуть: достигла
достижение: достижений
дуальный: дуальная, дуальной
елена: елена
заведение: заведений
задача: задач
заказывать: заказывавшие
запрос: запросам
знание: знаниями
значительный: значительную, значительные, значительный, значительным, значительных
играть: играла, играли
из: из
издательство: издательство
изменение: изменения
иметь: имеющий
индустриализация: индустриализации
инновационный: инновационные, инновационных
институт: институты
испытывать: испытывали
исторический: исторический
история: история
кадр: кадрах, кадров, кадры
кадровый: кадровым
как: как
квалификация: квалификации
квалифицировать: квалифицированные, квалифицированных
ключевой: ключевой, ключевые, ключевых
книжный: книжное
когда: когда
колхоз: колхозы
комбинат: комбинаты
комплекс: комплекс
комплексный: комплексных
компьютерный: компьютерные, компьютерных
конец: конца, конце
контекст: контекст
который: которые
край: крае, край, края
краснодар: краснодар
краснодарский: краснодарский, краснодарского, краснодарское, краснодарском
крупный: крупные, крупных
кубанский: кубанский
курс: курсов
лаборатория: лабораторий
литература: литературы
мастерская: мастерских
материально: материально
метод: методов, методы
многие: многие
многочисленный: многочисленных
модернизация: модернизации
можно: можно
молодёжь: молодежи, молодежь
москаленко: москаленко
мотивировать: мотивировало
навык: навыков
нацелить: нацеленные
начало: начала, начале, началу
начаться: начавшаяся
негативно: негативно
необходимый: необходимую
непрерывный: непрерывного
несколько: несколько
несмотря: несмотря
новый: новым, новыми, новых
нуждаться: нуждались, нуждался
обеспечение: обеспечение, обеспечением
обеспечивать: обеспечивая
обладать: обладала, обладая
обновление: обновление
оборудование: оборудование
образ: образом
образование: образование, образованию, образования
образовательный: образовательная, образовательной, образовательном, образовательные, образовательных
обучаться: обучающиеся, обучающихся
обучение: обучение, обучении, обучения
общеобразовательный: общеобразовательные
общесоюзный: общесоюзной
общественный: общественные
обязательный: обязательного
один: одним, одной
однако: однако
оказать: оказав
окончание: окончании
они: их
ориентация: ориентация
ориентироваться: ориентироваться
оснащение: оснащение
основной: основные
особенность: особенностей
особый: особое
открытие: открытию
отметить: отметим, отметить
отразиться: отразилось
параллельно: параллельно
педагогический: педагогических
период: период
плотный: плотное
повлиять: повлияли
повышать: повышало
повышение: повышения
подготовка: подготовке, подготовки, подготовкой, подготовку
поддержка: поддержка, поддержки
подход: подход
позволять: позволяли
политика: политика, политики
помимо: помимо
последующий: последующие
поступать: поступать
потенциал: потенциал, потенциалом
потребность: потребности, потребность
практический: практической
предмет: предметы
предпосылка: предпосылки
предприятие: предприятий, предприятия, предприятиями, предприятиях
предусматривать: предусматривали
прежде: прежде
преподавательский: преподавательского
преподавать: преподавали
претерпеть: претерпела
привести: привели, привело
прикладной: прикладными
принимать: принимавшие
проблема: проблемы
проведение: проведение
программа: программ, программах, программы
продолжать: продолжала
производственный: производственные
производство: производства, производстве
промышленность: промышленности, промышленность
промышленный: промышленный, промышленным, промышленных
профессионально: профессионально
профессиональный: профессионального, профессиональное, профессиональных
процесс: процесс, процессе
пту: пту
работа: работу, работы
работать: работать
работодатель: работодателей, работодателями
рабочий: рабочих
разветвить: разветвленной
развивать: развивал
развиваться: развивалось
развивающийся: развивающейся
развитие: развитие, развитии, развития
различный: различных
рамка: рамках
распад: распад
рассматривать: рассматриваемый, рассматривало
рассматриваться: рассматривается
расти: росла
реальный: реального
регион: регион, региона, регионе, регионов
решающий: решающую
роль: роль
россия: россии
рост: роста, ростом, росту
рф: рф
рынок: рынке
рядом: рядом
с: со
связать: связаны
связь: связи
сделать: сделать
сектор: сектора
сельский: сельского, сельское
сельскохозяйственный: сельскохозяйственный, сельскохозяйственным
система: система, системе, системы
слово: слова
снижение: снижению
совершенствование: совершенствованию
современность: современность
содействовать: содействовавшие, содействовали
создание: созданию, создания
соискатель: соискатель
соответствующий: соответствующих
состав: состава, составом
социально: социально
социальный: социальное
социум: социум
сочетаться: сочеталось
специалист: специалистов
специальность: специальностей
специфический: специфические, специфических
список: список
способствовать: способствовал, способствовала, способствовали
среднее: среднего
ссср: ссср
становление: становлении
стать: стал, стали, стало
статья: статье
стимулировать: стимулировавшим
стоить: стоит
сторона: стороны
стремительно: стремительно
строительство: строительство
существенно: существенно
счёт: счет
сыграть: сыграли
такой: таким, такой
теоретический: теоретическое
технический: техническая, технические, техническим, технического, техническое, технической, техническую
технология: технологии, технологий, технологиями
только: только
требовать: требовало
требоваться: требовались
труд: труда
трудность: трудности
трудоустройство: трудоустройства, трудоустройству
уделяться: уделялось
умение: умениями
университет: университет
уровень: уровня
условие: условий, условия, условиям, условиях
усложнить: усложнило
успех: успехов
успешный: успешному
участие: участие
учебный: учебно, учебный, учебных
училище: училищ, училища
учиться: учащихся
учреждение: учреждений, учреждения, учреждениях
фактор: фактором
фгбоу: фгбоу
феникс: феникс
финансирование: финансирование, финансировании, финансирования
финансовый: финансовые
функционирование: функционирование
функция: функции
характерный: характерных
химический: химическую
хозяйство: хозяйства, хозяйство
целевой: целевой
ценность: ценность
центр: центров
черта: черт
число: числа
что: что
экономика: экономики, экономику
экономический: экономические, экономическим, экономического, экономическое
элемент: элемент
энергетический: энергетическую
это: этим, это, этом
этот: эти, этот
