аббревиатур: аббревиатурой
август: августа, августе
авт: авт
активн: активно
актуальност: актуальности
акцентировал: акцентировали
александр: александров
александров: александрова
александровн: александровна
английск: английской
аннотация: аннотация
арми: армии
артиллерийску: артиллерийскую
артиллерия: артиллерия
атак: атаки
бабанин: бабанин
баланс: баланса
батаре: батарею
башн: башни, башню
башня: башня
без: без
бензин: бензин
березовы: березовые
берлинск: берлинской
битв: битве
бо: бо
боев: боев, боевая, боевых
боеву: боевую
боевы: боевые
бой: бой
боле: более
больш: больше, большое, большой
большевик: большевиков
бою: бою
боя: боя
боялис: боялись
боях: боях
бро: броней
брод: брода
брон: броне, брони, броню
бронев: броневая, броневой, броневых
броневу: броневую
броневы: броневые
бронезащит: бронезащита, бронезащиту
бронелист: бронелистов
бронестойкост: бронестойкость
бронетанков: бронетанковой
бронировани: бронирование, бронированием
бронированн: бронированной
броня: броня
бт: бт
был: был, была, были, было
быстр: быстрого
быстроходны: быстроходные
быт: быть
важн: важно
важнейшим: важнейшим
варьировалас: варьировалась
ввязываться: ввязываться
вел: вел, вела, вели
велас: велась
велик: великая, великой
вермахт: вермахта
весил: весил
вид: видов
виккерс: виккерс
витали: виталий
влияни: влияние
вмест: вместе, вместо
вмятин: вмятин
внимани: внимание
вов: вов
военн: военное, военной, военных
военны: военные
возмож: возможного
возможност: возможность
возникл: возникла
войн: война, войне, войной, войны
войнах: войнах
войск: войск
вооружени: вооружение, вооружением, вооружении
вооружения: вооружения
вопрос: вопрос, вопросов, вопросу
воронцов: воронцова
ворошил: ворошилов
восточн: восточный
вперед: вперед
времен: времени
время: время
все: всей
всегд: всегда
встал: встал
втор: второго, второй
выигрывал: выигрывали
выполнял: выполняли
выпрямлен: выпрямлен
выпуск: выпуск
выпускаться: выпускаться
выпущен: выпущена
высот: высота
выстрел: выстрелом
вытянут: вытянута
выходит: выходить
гг: гг
геологоразведоч: геологоразведочного
геополитическ: геополитического
гитлеров: гитлеровских
гко: гко
главн: главный, главным
глаз: глазами
глубин: глубина
глубок: глубоко
год: год
гол: гол
гор: горного
горизонт: горизонт
государств: государства
государствен: государственного
град: град
груз: грузами
грузовик: грузовиков
гудериан: гудериан
гусениц: гусеницами
даж: даже
дан: данного
данн: данный
дат: дата
двигателя: двигателя
девят: девятого
действи: действий
действия: действия
действиях: действиях
декабря: декабря
дел: дела
делал: делало
ден: день
детал: детали
дешев: дешевым
дивизи: дивизии
дизель: дизельного
дизельн: дизельное
диктовал: диктовала
дня: дня
до: до
довест: довести
довольн: довольно
долги: долгий
должн: должно, должны
дорог: дороге
достоинств: достоинств
доц: доц
др: др
друг: другое, другой
други: другие
дуг: дуге
думается: думается
его: его
единственн: единственно, единственный
ее: ее
еженедельник: еженедельник
железн: железных
желт: желтов
жив: живой
живучим: живучими
завод: завода, заводе
заводах: заводах
заграждения: заграждения
заграничн: заграничных
задержал: задержал
заключени: заключение
заметн: заметно
замолчат: замолчать
заняв: заняв
запрещавш: запрещавшая
запуск: запуска
заставит: заставить
зат: затем
защит: защита, защиту, защиты
защищенность: защищенностью
звезд: звезда
зенитк: зенитки
значени: значение
из: из
изготовлен: изготовлены
изготовлени: изготовлении
изменения: изменения
изменил: изменили
изучени: изучение
им: им
имел: имел, имела
имен: имени
именн: именно
имея: имея
ими: ими
индекс: индекс, индексом
инженерн: инженерных
инженерны: инженерные
институт: институт
инструкция: инструкция
ину: иную
иосиф: иосиф
ис: ис
испани: испании
исполнилос: исполнилось
использовал: использовали
использовалис: использовались
использовани: использование
использоват: использовать
используем: используемое
испытани: испытаний
испытания: испытания
исследуется: исследуется
ист: ист
история: история
итог: итоге
их: их
июл: июле
июн: июнь
кавэшек: кавэшек
как: как
калибр: калибр, калибра
кампани: кампаний
канд: канд
катан: катаных
кафедр: кафедра
качеств: качества, качестве
кб: кб
кв: кв
кершо: кершоу
кировец: кировец
кировск: кировского, кировском
класс: классе
клим: клим
ключевы: ключевые
км: км
количеств: количество
колмык: колмыков
колонн: колонну
командир: командира
командовани: командованию
комиссар: комиссаров
комитет: комитета
конечн: конечно
конкретн: конкретной
конструктивн: конструктивными
конструктор: конструктор, конструкторы
конструкци: конструкции, конструкцию
конструкция: конструкция
контрнаступлени: контрнаступлении
конус: конуса
конц: конце, концу
коробк: коробка, коробку
корпус: корпус, корпуса
котин: котин
котор: которой, которых
которы: которые
красн: красной
крепку: крепкую
крест: кресты
кром: кроме
кругову: круговую
кубинк: кубинке
курск: курской
легк: легкого
легки: легкий
легкопробиваем: легкопробиваемая
ленинград: ленинграде
лет: лет
лист: лист, листов
лит: литая, литой
литератур: литературы
литу: литую
лицензи: лицензии
лиш: лишь
лобов: лобовой
лучш: лучше, лучших
лучшим: лучшими
лучшу: лучшую
льшу: льшую
люд: люди
мае: мае
максимальн: максимально
максимум: максимуму
мал: мало
мамонт: мамонтов
маневренност: маневренность
маневренны: маневренные
март: марта
масс: масса, массе, массу, массы
машин: машина, машине, машины
мая: мая
медленну: медленную
межд: между
меньш: меньше, меньшей
мест: места, место
месяц: месяцев
милен: милена
миров: мировой
мм: мм
мнения: мнения
мног: много, многое
мог: мог
модел: моделей, модели, модель
модель: моделью
можн: можно
мотор: моторов
мощн: мощной, мощным
мощност: мощность
мощны: мощные
мощь: мощью
наглядн: наглядно
надежн: надежной
надежну: надежную
назначения: назначения
называем: называемый
называл: называли
называют: называют
наибольш: наибольшей
наканун: накануне
наклон: наклон, наклона
направил: направили
народ: народа
народн: народных
наступательн: наступательных
наталья: наталья
наук: наук
научн: научный
находившихся: находившихся
начал: начала, начале
наш: наш, нашего, нашей, наши, наших
невредим: невредимы
невысоку: невысокую
недоработк: недоработки
недостатк: недостаткам, недостатками, недостатков
некоторы: некоторые
нем: нем, немного
немедленн: немедленно
немецк: немецких
немецки: немецкие
немецким: немецкими
немц: немцев, немцы
нескольк: несколько
несмотря: несмотря
неуязвим: неуязвимыми
никогд: никогда
ним: ними
нов: новая, нового, новой, новых
новац: новациями
нову: новую
нос: нос
носов: носовой
нужн: нужны
об: об
обеспечени: обеспечении
обеспечивал: обеспечивало
обеспечит: обеспечить
обзор: обзор
обнаружилос: обнаружилось
обозрени: обозрение
оборон: обороны
оборонительн: оборонительных
образц: образцы
обращения: обращения
обречен: обречен
обстановк: обстановки
обстрел: обстрел
общ: общей
общим: общими
объективны: объективные
огнев: огневой, огневых
огон: огонь
ограниченн: ограниченный
ограниченну: ограниченную
огромн: огромное
один: один
одиночн: одиночном
одн: одна, одни
одним: одним, одними
одновременн: одновременным
оказавши: оказавшие
оказал: оказал
оказалас: оказалась
окончания: окончания
он: он
она: она
они: они
оперативн: оперативно, оперативной
операци: операции
операциях: операциях
оптимальн: оптимальное, оптимальной
опыт: опыт
опытны: опытные
организаци: организации
орджоникидз: орджоникидзе
оригинальн: оригинальная
оруд: орудиями
оруди: орудием
орудия: орудия
оружия: оружия
оскол: оскол
оснащени: оснащении
основ: основу
основн: основное, основном
основны: основные
особ: особо
особенн: особенно
особенност: особенностями
оставлял: оставляли
осталис: остались
остаются: остаются
осуществлялос: осуществлялось
от: от
ответн: ответный
отечественн: отечественная, отечественной
отличался: отличался
отметит: отметить
отмечается: отмечается
отнест: отнести
отправил: отправили
отражал: отражал
отражен: отражены
отроков: отрокова
очен: очень
павл: павлов
панцервафф: панцерваффе
параллельн: параллельно
перв: первая, первый
первы: первые
перед: перед
передач: передач
перезарядк: перезарядку
перестал: перестали
период: период
пехот: пехоты
плит: плиты
побед: победы
победн: победный
поверхност: поверхности
повоеват: повоевать
повысит: повысить
под: под
подвижност: подвижность
подоб: подобного
подтащив: подтащив
подтверждают: подтверждают
подъем: подъема
пожаробезопасн: пожаробезопасным
позаимствовал: позаимствовали
позволил: позволили, позволило
позж: позже
позици: позицию
показ: показа
показал: показал
показан: показаны
пол: поле
полагают: полагают
полигон: полигоне
полигонны: полигонные
полуавтоматическу: полуавтоматическую
получил: получил, получила
полях: полях
попал: попали
портал: портал
поскольк: поскольку
посл: после
послевоен: послевоенного
последн: последнего
последни: последние
последующе: последующее
постановлени: постановление
пот: потому
потерял: потеряло
потребност: потребность
потребовал: потребовали
потребовалос: потребовалось
поэт: поэтому
появилас: появилась
появилис: появились
появлени: появлением
правительств: правительство, правительством
предложен: предложена
предложил: предложили
предназначен: предназначен
предстоял: предстояло
предыдущ: предыдущих
прежн: прежнему
преимуществ: преимущества
преодолеваемы: преодолеваемые
препятствия: препятствия
при: при
прибалтик: прибалтике
признан: признан
признанны: признанные
применения: применения
применялис: применялись
применялос: применялось
принимал: принимали
принят: принят, принята, принято
приняти: принятии
приобрест: приобрести
природопользования: природопользования
приходилос: приходилось
прицельн: прицельным
пришлос: пришлось
пробит: пробить
проведен: проведена
проводилис: проводились
продвижени: продвижение
продемонстрироват: продемонстрировать
проект: проекту
производиться: производиться
производств: производстве, производство
прорыв: прорыва, прорывов
просту: простую
против: против
противник: противника
противоположну: противоположную
противоснарядну: противоснарядную
противотанков: противотанковая, противотанковых
противотанковы: противотанковые
прохоровск: прохоровской
прошл: прошло
проявилис: проявились
проявилос: проявилось
прям: прямо
пут: пути, путь
пушек: пушек
пушк: пушка, пушками, пушки, пушкой, пушку
работ: работа
раз: раза
развиват: развивать
развити: развитие
развития: развития
разгоняться: разгоняться
раздавил: раздавил
различны: различные
размер: размеры
разработан: разработана
разработк: разработке, разработки
разработчик: разработчики
район: район, района
рапорт: рапорт
расстрелял: расстрелял
рациональн: рациональная
ред: ред
ресурс: ресурс
решающ: решающая
решил: решило
ркк: ркка
рол: роль
романович: романович
росси: россии
российск: российского
руководител: руководителем, руководитель
рф: рф
ряд: ряд
сал: салов
сам: самым
сваривался: сваривался
сво: свое, своего, своей, своем, свои
своим: своими
связ: связи
связанн: связанных
сделат: сделать
серг: серго
серге: сергеев
сери: серии
серийн: серийно
серьезн: серьезно
сил: силы
сильнейшим: сильнейшим
сильны: сильные
систем: системе
скорост: скорость
скоростн: скоростной
слаб: слабое
следующе: следующее
следующи: следующие
слов: слова
сложн: сложный
сложност: сложности
см: см
смогл: смогли
снабженческим: снабженческими
снаряд: снаряды
сначал: сначала
снизил: снизили
снизит: снизить
снк: снк
со: со
соблюдени: соблюдение
собран: собран
собственны: собственные
совершенствования: совершенствования
совет: совете, советских, советское
советск: советского
советски: советские
современн: современных
сожалени: сожалению
создават: создавать
создается: создается
создани: созданием, созданию
создания: создания
создат: создать
сооружени: сооружений
соответственн: соответственно
соответстви: соответствии
соответствовал: соответствовали
сопровождени: сопровождение
соревнования: соревнования
сост: сост
составлявшу: составлявшую
составлял: составляло
сочетани: сочетание
союз: союза
специальн: специальной, специальный
список: список
справедлив: справедливо
сравнени: сравнению
сражени: сражений
средни: средний
срочн: срочно
ссср: ссср
стал: стала, стали
сталин: сталин, сталина
сталинград: сталинградом
стар: старый
старалис: старались
староосколь: старооскольский
стать: статье
стен: стены
степен: степени
стефановн: стефановна
стойкост: стойкость
сторон: сторону
стратегическу: стратегическую
студент: студент
ступен: ступени
суток: суток
сухопутн: сухопутных
существенн: существенным
существуют: существуют
считавшиеся: считавшиеся
считают: считают
таблиц: таблице, таблицу
так: таких, такого, такое
таким: таким
тактик: тактико
танк: танк, танка, танки, танков, танком
танках: танках
танкист: танкисты
танков: танковой, танковых
танкомастер: танкомастер
танкостроени: танкостроение
танкостроения: танкостроения
тезис: тезис
тем: тем
тепер: теперь
техник: техника, техники, техникой
техниче: технических
технически: технические
тигр: тигр, тиграм
тиграх: тиграх
тип: типа
тог: того
толщин: толщина, толщиной, толщину, толщины
тольк: только
том: том
тонн: тонн
топлив: топливо
точек: точек
тошев: тошева
тракторн: тракторном
требовани: требование
требованиям: требованиям
ттх: ттх
тут: тут
тыл: тыла
тяжел: тяжелого, тяжелый, тяжелых
тяжелы: тяжелые
увеличения: увеличения
увеличит: увеличить
угл: углы
угол: угол
удавалос: удавалось
удалос: удалось
уже: уже
указывал: указывал
укреплен: укрепленного
укрепленн: укрепленных
уложен: уложены
уменьшив: уменьшив
уменьшил: уменьшили
университет: университета
уничтожалис: уничтожались
уничтожени: уничтожение, уничтожением
уничтожил: уничтожил
усиленну: усиленную
усилит: усилить
условия: условия
условиях: условиях
успеш: успешного
успешн: успешно
установил: установили
установк: установке
установленн: установленными
уступил: уступили
участвовал: участвовала
участи: участие
учет: учет
февраля: февраля
федеральн: федеральный
филиал: филиал
филос: филос
фин: финский, финских
фирм: фирмы
форм: форму
фронт: фронт
функци: функции
хайнц: хайнц
халкин: халкин
характеристик: характеристик, характеристики
ход: ходе
ходов: ходовой
хороши: хорошие
хорошу: хорошую
хотелос: хотелось
хоттиненск: хоттиненского
цифр: цифры
част: части
частност: частности
чел: чел
челябинск: челябинске, челябинском
чем: чем
через: через
числ: числе
чтз: чтз
что: что
широк: широко
шт: шт
щучи: щучий
эволюция: эволюция
экипаж: экипаж
экономик: экономики
эксм: эксмо
эксплуатаци: эксплуатации
электронн: электронный
элемент: элементом
эта: эта
эти: эти
это: это, этой
этог: этого
этом: этом
эшелонированн: эшелонированной
являлис: являлись
являлся: являлся
япони: японии
