активн: активно
активност: активности
активны: активные
анализируется: анализируется
аристократ: аристократией
аристократи: аристократии, аристократию
аристократия: аристократия
арми: армию
без: без
би: би
болин: болин
будущи: будущий
будущим: будущим
был: были
важн: важными
ван: ван
варвар: варваров
век: веков
вел: вел
велик: великих
вклад: вклад
власт: власти, власть
влияни: влияние, влиянию
влиятельн: влиятельных
внедрил: внедрил
внимани: внимание
военачальник: военачальник, военачальников
военн: военное, военной, военных
военну: военную
военны: военные
войнах: войнах
восем: восемь
восстани: восстание, восстаний
восстаниям: восстаниям
восточн: восточной
восточну: восточную
вплот: вплоть
всем: всему
вспыхнувше: вспыхнувшее
вторжения: вторжения
выдающийся: выдающийся
выдающихся: выдающихся
выделился: выделился
вызвал: вызвали
высш: высших
выходц: выходцев
вышедши: вышедшие
вэй: вэй
вэн: вэнь
ганьс: ганьсу
гао: гао
гаоцз: гаоцзу
гарнизон: гарнизона, гарнизоне, гарнизонов, гарнизоны
гарнизонах: гарнизонах
генерал: генерал, генералов
гипотез: гипотезы
год: году
город: города
государств: государства, государство
государственн: государственной, государственный
готовит: готовить
границ: границе
группировк: группировка, группировки
гуан: гуан
гуанлин: гуанлин
гуанлун: гуанлунская
гуанлунг: гуанлунгская
гуанлунск: гуанлунской
гуанлунску: гуанлунскую
гуанпин: гуанпин
гуаньчжун: гуаньчжун
губернатор: губернатор
гуй: гуй
гун: гун
да: да
дао: дао
двух: двух
ди: ди
династи: династии, династию
династия: династия
до: до
доу: доу
древнекитайским: древнекитайским
дуг: дугу
его: его
ее: ее
ест: есть
жужанск: жужанского
заговор: заговор, заговоре
западн: западная, западной
западну: западную
захватил: захватил
знат: знатного
игр: играя
играл: играл
из: из
известн: известный, известных
издани: издание
имел: имели
имен: имени
император: император, императоров
истори: истории
итог: итоге
их: их
каганат: каганата
казахстан: казахстан
как: как
кампани: кампании, кампаний
кафедр: кафедра
кит: китая
кита: китаем, китаю
китаизаци: китаизации
клан: клан, клана, кланы
класс: класса
ключев: ключевых
ключеву: ключевую
ключевы: ключевые
книг: книга
княз: князь
командующ: командующих
командующим: командующими
конечн: конечном
контрол: контролем
контролировал: контролировал
котор: которая, которое, который, которых
которы: которые
кочев: кочевых
крупн: крупное, крупный
культур: культуру
куо: куо
ланьсян: ланьсян
лидер: лидеров
литератур: литературы
лу: лу
лунс: лунси
межд: между
меньш: меньше
мног: многих
момент: моментом
мустаф: мустафа
мятеж: мятеж
набиралис: набирались
названи: название
назначени: назначение
назначив: назначив
называт: называть
народ: народы
населени: население, населением
находилис: находились
начал: начал, начали
началос: началось
нег: него
недовольств: недовольство
нин: нин
них: них
нов: новое
нурланович: нурланович
област: области
обсуждается: обсуждается
обществ: обществе
объединени: объединение
один: один
они: они
оно: оно
опытн: опытных
организовав: организовав
организованн: организованных
ослаблени: ослаблению
основ: основой
основав: основав
основавш: основавшему
основал: основало
основател: основателем, основатель
основателя: основателя
основн: основной, основном
основны: основные
особ: особое
особенн: особенно
от: от
отец: отец
ощущалис: ощущались
падени: падение
переворот: переворот
перенял: переняли
переход: переходе
перешл: перешла
период: период
племен: племен
пограничн: пограничных
под: под
подверглос: подверглось
подготовил: подготовил
поддерживал: поддерживал
поздне: позднее
политик: политике, политики, политику
политиче: политическая
политическ: политической
политическу: политическую
полководец: полководец
полководц: полководцев
положени: положению
помогал: помогали
поселени: поселений
поскольк: поскольку
посл: после
последствия: последствия
почв: почву
правителях: правителях
правлени: правление
правящ: правящего
пратяжени: пратяжении
пределах: пределах
предок: предок
предотвратит: предотвратить
представител: представитель
преобразовани: преобразовании
при: при
приближённ: приближённых
привел: привело
приграничн: приграничных
приняв: приняв
провинци: провинций
провинция: провинция
происходит: происходит
происходят: происходят
происхождени: происхождение
против: против
противостоят: противостоять
путат: путать
разделени: разделению
разделения: разделения
рассматривается: рассматривается
расширил: расширили
реальн: реальной
регент: регент
регион: регионов
результат: результате
репринтн: репринтное
решающим: решающим
род: рода
рол: роль
сам: самых
сверг: сверг
свергл: свергла
сво: свое
север: севере, северного
северн: северная, северной
северну: северную
сем: семей
семь: семьи
си: си
син: синь
сист: систему
систем: система, системы
слов: слова
служил: служили
смешанн: смешанное
смешиваться: смешиваться
соб: собой
собрал: собрал
современн: современная, современных
соединив: соединив
создал: создали
создани: создание
создания: создания
составлявши: составлявшие
список: список
способствовал: способствовало
сред: среди
средневеков: средневекового
стал: стал, стали, стало
стар: старая
стать: статье
столп: столпов
стран: страны
стратег: стратегов
стратегическ: стратегически
стремяс: стремясь
студент: студент
суй: суй
сулеймен: сулейменов
сформировал: сформировал, сформировали
считается: считается
сын: сын
сюн: сюн
сяньб: сяньби
сяньбий: сяньбийское
сяовэн: сяовэнь
тай: тай
тан: тан
тая: тая
территори: территории
тест: тесть
тог: того
традиц: традициями
увэ: увэй
уделяется: уделяется
укреплени: укреплению
университет: университет
уникальн: уникальному
уникальну: уникальную
управлени: управлением
управлял: управляла
устаревше: устаревшее
устранив: устранив
участвовал: участвовал
участник: участник
учуан: учуань
учуаня: учуаня
фактиче: фактический
фаньян: фаньян
формальн: формально
формирования: формирования
фубин: фубин, фубинская
фубинск: фубинской
хань: ханьское
ханьц: ханьцев, ханьцы
хоумочэн: хоумочэнь
ху: ху
хуайан: хуайань
хуан: хуана
хунн: хунну
хэ: хэ
ценност: ценности
центр: центрами
церемониальну: церемониальную
цзан: цзан
цзин: цзинь
цзинчжо: цзинчжоу
цзян: цзянь
цзяня: цзяня
ци: ци
циньчжо: циньчжоу
цичжо: цичжоу
част: часто
чжа: чжао
чжо: чжоу
чжун: чжун
что: что
шакарим: шакарима
шест: шести, шесть
шун: шунь
шэньс: шэньси
элит: элитой, элиту, элиты
эпох: эпоху
эти: эти
этих: этих
юан: юань, юаню
юй: юй
юйвэн: юйвэнь
юньчжо: юньчжоу
янпин: янпин
янь: янь
