автор: автор, автора, авторов
авторитет: авторитет
авторств: авторство, авторству
азов: азова
активн: активно
алексеевн: алексеевны
алексея: алексея
анализ: анализа
аннотация: аннотация
антиправительственн: антиправительственным
аристократи: аристократии
аристократия: аристократия
архив: архивам
базируяс: базируясь
безнравственн: безнравственной
биографи: биографии, биографию
биографическ: биографического
богослов: богословский
богословск: богословского
борьб: борьба, борьбе, борьбы
бояр: бояр
боярск: боярского, боярскому
брат: брата
брикнер: брикнер, брикнера
буган: буганов
буганов: буганова
буланин: буланин
бунин: бунина
бунт: бунт, бунта, бунте, бунтов, бунту, бунты
бунтах: бунтах
бунташ: бунташого
бунтовщик: бунтовщиками
был: был, была, были, было
быт: быть
ва: ва
важн: важное, важным
вв: вв
век: века
велик: великого, великом
велики: великий
верн: верными
вернется: вернется
вернувшегося: вернувшегося
вернут: вернуть
вернуться: вернуться
верхушк: верхушки
весн: весна, весной, весны
взгляд: взгляда, взглядов
взявшихся: взявшихся
взят: взятого
взятия: взятия
видел: видел, видела, видели
видим: видим
винил: винил
виновност: виновности
власт: власти, власть
влияни: влияние
вмест: вместе
внов: вновь
военн: военной, военных
возведени: возведение
возвращени: возвращении
возглавляем: возглавляемых
возможн: возможное
возможност: возможность
возникновени: возникновение
воинск: воинской
войн: войне
войск: войска, войсками, войску
волнен: волнениями
вольф: вольф
вопрос: вопрос, вопросе, вопросу
воспользовалас: воспользовалась
воспользоваться: воспользоваться
восставш: восставших
восставшим: восставшими
восстани: восстание, восстанием, восстании, восстаний
восстания: восстания
восстат: восстать
восьмилетн: восьмилетнего
вошл: вошли
впервы: впервые
времен: времени
время: время
все: все
всеволод: всеволод
всех: всех
вслед: вслед
встречен: встречены
всю: всю
втор: второй
выборн: выборным
вывод: выводу
выводах: выводах
выводя: выводя
выделени: выделение
выделилос: выделилось
вызвавшим: вызвавшим
выразившейся: выразившейся
выступ: выступая
выступают: выступают
выступил: выступили
выступлени: выступлению
выступления: выступления
высш: высшая
выш: выше
гг: гг
георгиевич: георгиевич
глав: главе, главой
главах: главах
главн: главной
глобальн: глобальной
гнет: гнета
год: год, годом, годы
голиков: голикова, голиковой
госполитиздат: госполитиздат
государств: государства, государстве
государствен: государственного
государственн: государственном, государственный, государственным
готовившегося: готовившегося
границ: границей, границы
грядущ: грядущем
дается: дается
дал: дала
дальнейш: дальнейшей
дан: дано
данн: данной, данном, данному, данный, данных
движени: движением
движущи: движущие
двор: дворе
двух: двух
дезертир: дезертиров
действовавши: действовавший
дел: дела, дело, делу
делал: делали
дмитри: дмитрий
доверия: доверия
доказательств: доказательств
документ: документов, документы
документах: документах
долг: долгое
должн: должно, должны
доминировавше: доминировавшее
доминирующим: доминирующим
допрашивалис: допрашивались
допущен: допущен
дореволюционн: дореволюционной, дореволюционных
достижени: достижением
достоверность: достоверностью
доступн: доступных
друг: друг, друга, других
другим: другими
его: его
единственн: единственным
ее: ее
ей: ей
екатерин: екатерины
елец: елец
елецки: елецкий
ещё: ещё
ею: ею
женщин: женщине
жестоки: жестокие
жив: жив
жизн: жизни, жизнь
журнал: журнал
заговор: заговор, заговора, заговоре, заговором
заговорщик: заговорщики, заговорщиков
заграничн: заграничной, заграничном
заключения: заключения
закономерн: закономерное
закрепил: закрепило
закреплен: закреплено
заменен: заменены
занят: занять
заняти: занятием
западны: западные
засиль: засильем
заступничеств: заступничество
затрагивалас: затрагивалась
затянувшегося: затянувшегося
зрения: зрения
играт: играть
иде: идеи
идеологизированност: идеологизированность
идеологическ: идеологической
идт: идти
из: из
известн: известны
изд: изд
издавши: издавший
издал: издал
издани: издание, издании
издательств: издательство
изложил: изложил
изменени: изменением
изменения: изменения
изучени: изучение
им: им
имел: имело
именн: именно
император: императора
императорск: императорской
инициатив: инициативу, инициативы
ино: иной
иног: иного
иностранц: иностранцев
интригах: интригах
исключ: исключая
использовал: использовала
исследовани: исследований
исследования: исследования
исследованиях: исследованиях
исследовател: исследователем, исследователи, исследователь
истори: истории, историю
историк: историк, историка, историкам, историками, историко, историков
историографи: историографии
историография: историография
историче: исторических
историческ: исторической
исторически: исторические
история: история
источниках: источниках
их: их
июньск: июньского
июня: июня
казакевич: казакевич
как: как
караул: караулы
касаяс: касаясь
категори: категории
кафедр: кафедра
качеств: качестве
клан: клана
классов: классовой
ключевы: ключевые
князьк: князьков
ког: кого
конц: конца
концептуальны: концептуальные
конъюнктур: конъюнктуры
кооперативн: кооперативное
котор: которая, которое, которой, который, которыми, которых
которы: которые
крайн: крайне
кратк: краткая
крестьянск: крестьянской
кром: кроме
круг: круги, кругов
кругл: круглый
крупнейш: крупнейших
культур: культурного
купеческ: купеческого
курс: курс
лекци: лекции, лекций
лет: лета, летом
литератур: литературы
лиц: лице
личност: личность
лиш: лишь
люд: людей
ляпин: ляпин
марксистск: марксистской
марф: марфой
материал: материалам, материалы
межд: между
мене: менее
мест: места, место, месту
меч: меч
милослав: милославских
мнени: мнение, мнению
мнения: мнения
мног: многом
могл: могли
монарх: монарха
монастыр: монастырю
монастыря: монастыря
монографи: монографии, монографию
москв: москве, москву, москвы
москов: московских
московск: московского, московском
московски: московские
мотив: мотивами
мотивах: мотивах
мужску: мужскую
мы: мы
мятеж: мятеж, мятежа, мятежи
наблюда: наблюдаем
над: над
назван: названо
назревающ: назревающих
называвш: называвших
называет: называет
называл: называл
наиболе: наиболее
наибольш: наибольшей
найт: найти
наложенн: наложенная
направлени: направление
например: например
народн: народный, народным
населения: населения
наследия: наследия
настоящ: настоящей
настроенн: настроенных
настроил: настроил
наступления: наступления
наук: наука, науки
научн: научный
научны: научные
начал: начал, начала, начало
начат: начатым
начинан: начинаниями
начинающимися: начинающимися
наш: нашему
нашел: нашел
нег: него
недавн: недавно
недел: неделе
недовольн: недовольна, недовольных
недовольны: недовольные
недовольств: недовольства, недовольство, недовольством
недостатк: недостатка
недостойн: недостойной
неизбежн: неизбежным
нем: нему
немецк: немецкой
ненавист: ненависти
необходимост: необходимости
непосредственн: непосредственно, непосредственным
несения: несения
нест: нести
неудачн: неудачном
нехватк: нехватки
нибуд: нибудь
низложит: низложить
никак: никаких
никол: николая
ним: ними
нов: новых
новодевичь: новодевичьему
новоиерусалимск: новоиерусалимского
новы: новые
обеспокоенны: обеспокоенные
обзор: обзор
обозначенн: обозначенная
обосновывал: обосновывал
образ: образом
обращения: обращения
обусловил: обусловил
обширну: обширную
общим: общим
объект: объект, объекта
объяснял: объясняла
огиз: огиз
оговор: оговор
одним: одним
однозначн: однозначно, однозначной
оказал: оказал
окончательн: окончательно
окружени: окружении
он: он
она: она
они: они
опальн: опальной
оперировал: оперировали
опираяс: опираясь
описал: описал
описания: описания
оппозиционн: оппозиционная, оппозиционных
определил: определил, определила
определял: определял
определялос: определялось
опубликовал: опубликовал, опубликовала
опубликованн: опубликованном
опят: опять
организаци: организации
освещаются: освещаются
освещен: освещены
осен: осени
оскорбленн: оскорбленными
основ: основе
основн: основных
основны: основные
особ: особой
особенност: особенности
оставаяс: оставаясь
оставлен: оставленного
от: от
отверг: отвергая
отдельн: отдельное
отечественн: отечественной, отечественных
открыт: открытого, открытое
отмен: отмены
отмеч: отмечая
отмечает: отмечает
отмечал: отмечал, отмечала
относит: относит
относительн: относительно
относится: относится
отношени: отношение, отношении
отношения: отношения
отражают: отражают
отсутстви: отсутствием
отход: отход
официальн: официальная, официальной
официальну: официальную
оценк: оценки
оценок: оценок
очевидн: очевидно
очеред: очередь
очерк: очерки
ошибочн: ошибочным
партия: партия
пасхальн: пасхальной
перв: первая, первого, первой, первым
перву: первую
первы: первые
переворот: переворота, перевороте
передал: передали
передислоцированн: передислоцированных
перемен: переменами
переменах: переменах
пересмотр: пересмотром
период: период, периода
петр: петр, петра, петре, петром, петру
петрович: петровича
петровск: петровской
петровску: петровскую
письм: письма, письмо
план: планов
платон: платонов
побывавш: побывавших
повторени: повторение
повторил: повторил
повторяет: повторяет
погр: погром
под: под
подавлени: подавлением
подавления: подавления
подальш: подальше
подач: подачи
подговорит: подговорить
подготовк: подготовки
поднимал: поднимал
поднимат: поднимать
подразумев: подразумевая
подробн: подробно
подробну: подробную
подручны: подручные
подстрекател: подстрекателем
подступах: подступах
подтолкнул: подтолкнуло
подчеркив: подчеркивая
поездк: поездке
позиц: позицией
позици: позиции, позиций, позицию
позиция: позиция
покушения: покушения
политиче: политическая
политическ: политической
политически: политические
полк: полки, полков
полн: полно
полнот: полнотой
половин: половина, половине, половины
положения: положения
поочередн: поочередно
попытавшейся: попытавшейся
попытк: попытка, попытке, попыткой, попытку
порядк: порядке, порядку
порядок: порядок
посвященн: посвященных
посвящённ: посвящённой
посетившим: посетившим
поскольк: поскольку
посл: после
послед: последней
последн: последнего
последовавш: последовавшего
последовавше: последовавшее
последовавши: последовавший
последовавшу: последовавшую
последовал: последовали
последовательн: последовательно
посольств: посольства, посольстве
пост: поста
пот: потому
потешны: потешные
поход: похода
почв: почву
правительств: правительства, правительству
правлени: правление
правления: правления
правот: правоты
превратит: превратить
предвзятост: предвзятость
предислови: предисловии
предмет: предметом
предопределил: предопределил
предполагалос: предполагалось
предпосылк: предпосылкам, предпосылки
предпосылок: предпосылок
предпринят: предпринята
представившуюся: представившуюся
представлени: представление, представлением, представлении, представлений
представления: представления
представлялся: представлялся
представляются: представляются
предшественник: предшественники
прежд: прежде
прежн: прежнему
прежни: прежние
преображенск: преображенского, преображенском
преобразовани: преобразованием
престол: престол
при: при
привыч: привычного
придворн: придворных
придворны: придворные
придерживается: придерживается
придерживался: придерживался
придерживаяс: придерживаясь
призыв: призывом
приказ: приказа, приказе
принадлежит: принадлежит
принципиальн: принципиально
приобретенн: приобретенное
приход: приходом
приходит: приходит
причастност: причастности, причастность
причин: причин, причиной, причину, причины
провалившейся: провалившейся
проведен: проведенного
провокаци: провокацию
продовольствия: продовольствия
продолжени: продолжение, продолжением
пролог: прологом
прослеживает: прослеживает
прослеживается: прослеживается
прост: простых
против: против
противостояни: противостояние
профессиональн: профессиональных
процесс: процессы
проявлени: проявлении
прям: прямым
пряму: прямую
публичны: публичные
пыталис: пытались
пят: пяти
работ: работ, работа, работе, работы
работах: работах
радикальн: радикальная
разбит: разбиты
развил: развил
развити: развитие
разгоревшейся: разгоревшейся
разин: разина
разобрав: разобрав
рамках: рамках
ране: ранее
раскрыт: раскрытого, раскрытый
раскрыти: раскрытием
расправ: расправы
распространен: распространено
распространилис: распространились
расследовани: расследование
расследования: расследования
рассматриваем: рассматриваемым
рассматривался: рассматривался
расформировани: расформировании
ратн: ратное
реакционн: реакционно, реакционной
регентств: регентства, регентстве
ремесленн: ремесленно
репрессив: репрессивного
реформ: реформ, реформа, реформам
реформатор: реформатора
решающ: решающего, решающей
риторик: риторике
розыск: розыска
рол: роль
ромодановск: ромодановского
роспуск: роспуске
росси: россии
российск: российского, российской
ротаци: ротацию
рубеж: рубежи
руководител: руководителем
русск: русской
русским: русскими
рф: рф
ряд: ряда
сам: сам, самих, самого, самой, самом
самовласт: самовластного
самостоятель: самостоятельного
самостоятельн: самостоятельная, самостоятельной, самостоятельный
сборник: сборник
свергнут: свергнуть
сверх: сверху
сво: своего, своей, своих, свою
связ: связи, связь
сделал: сделал
себ: себе
себя: себя
сезонн: сезонно
секретн: секретным
селиванов: селиванова
семеновск: семеновского
семь: семье, семьи
середин: середине
сестер: сестер
сестр: сестрами, сестре, сестру, сестры
сил: силы
скептическ: скептически
складываться: складываться
скор: скором
следствен: следственного
следует: следует
слиться: слиться
слобод: слободы
слов: слова
сложившимся: сложившимся
служб: службе, службу, службы
служил: служилого
слух: слухами, слухи
смен: смена, смены
сменилос: сменилось
сменяющ: сменяющих
смерт: смерти
смут: смуту, смуты
сниз: снизу
со: со
событи: событии, событий
события: события
событиям: событиям
событиях: событиях
совет: советский, советских, советское
советск: советской
советски: советские
солдат: солдат, солдатами
солдатск: солдатского
соловь: соловьев
сослов: сословиями
сословия: сословия
составил: составил
составн: составной
состоит: состоит
соучастниц: соучастницы
софь: софье, софьей, софьи, софью
софья: софья
сохранившиеся: сохранившиеся
сохранялис: сохранялись
социальн: социально
спб: спб
список: список
спланирован: спланированного
спланированну: спланированную
сражени: сражении
сред: среде, среди
ставш: ставшего
стал: стала, стали, стало
стать: статье, статьи
степан: степана
столиц: столице
сторон: сторону, стороны
сторонник: сторонниками
стоял: стояла, стояли
страдающи: страдающие
стран: стране
стрелецк: стрелецких, стрелецкого, стрелецкой, стрелецком, стрелецкому
стрелецки: стрелецкие, стрелецкий
стрельц: стрельцам, стрельцами, стрельцов, стрельцы
стремлени: стремление, стремлении
стриж: стриж
студент: студент
студенче: студенческий
суворин: суворина
судьб: судьбу
существовал: существовал
сформулировал: сформулировали
сформулирован: сформулирована
считал: считал
сытин: сытина
так: таки, такой
таким: таким
таков: таковому
те: те
тезис: тезисы
тем: тем, тема, темой, тему, темы
терминологи: терминологии
типография: типография
тог: того
той: той
тольк: только
том: том, томе
томах: томах
точк: точки, точку
традиционн: традиционным
трактовк: трактовке
треть: третьем
трон: трон
труд: трудов
убедив: убедив
убедительн: убедительной, убедительных
убийств: убийство
убит: убить
уверенност: уверенности, уверенность
угнетен: угнетенного
угнетенн: угнетенными
уже: уже
указывает: указывает
уклад: уклада
университет: университет, университета
упомянут: упомянутого
упразднения: упразднения
уровня: уровня
усилени: усилением
услал: услали
уставши: уставшие
устоявшейся: устоявшейся
устроенну: устроенную
устрял: устрялов
устрялов: устрялова, устряловым
утрат: утратой
утративш: утративших
утраченну: утраченную
ухватилас: ухватилась
ухудшени: ухудшение
учинен: учиненного
факт: факту
фактическ: фактического
фактор: фактора
феодальн: феодальной
фигурировал: фигурировал
форм: форме, формы
фундаменталь: фундаментального
фундаментальн: фундаментальная, фундаментальной
характер: характер
характеристик: характеристика
характерн: характерная, характерным
ход: ход
хот: хоть
хронологическ: хронологическом
цар: царский, царь
царевн: царевна, царевнам, царевнами, царевне, царевной, царевны
царск: царской
царств: царства
царствования: царствования
царя: царя
цел: целом
циклер: циклера, циклером
часть: частью
челобитчик: челобитчиков
челобить: челобитьем
четырех: четырех
числ: числа, числе
чистяков: чистякова, чистяковой
чтения: чтения
что: что
шатк: шатков
широк: широко
школ: школа
ых: ых
эксплуататор: эксплуататорами
эксплуататорск: эксплуататорского
электронн: электронный
элит: элиты
эпох: эпохе, эпохи, эпоху
эта: эта
этап: этапа, этапов
эти: эти
этим: этим
это: это, этой
этог: этого
этом: этом, этому
этот: этот
эту: эту
явилис: явились
является: является
янычар: янычарами
