автор: автор, авторов
азбук: азбуки
активн: активно
андр: андрей
анн: анна
аннотация: аннотация
антич: античного
античн: античных
археологически: археологические
архитектур: архитектура
белоозер: белоозерский
библиотек: библиотеки, библиотеку
благодаря: благодаря
благоустройств: благоустройство
бог: бога
богослужения: богослужения
божественн: божественному, божественных
божи: божий
боле: более
больш: большое
был: был, была, были, было
быст: бысть
важн: важными
васили: василий
введени: введение
век: века, веке
велики: великий
великим: великим
великокняже: великокняжеский
величайшим: величайшим
вершин: вершиной
взносах: взносах
византий: византийских
византийск: византийской
византийски: византийские
вклад: вклад
владимир: владимир, владимира, владимире, владимиро, владимиром, владимирская, владимирский
владимирович: владимирович
владос: владос
власт: власти
вмест: вместе
внешн: внешних
внимани: внимание
внутренни: внутренние
воздержани: воздержанием
возникл: возникла
волынск: волынского
вопрос: вопросу
воспитани: воспитание, воспитанию
воспитания: воспитания
воспитательн: воспитательной
воспитывалис: воспитывались
воспринят: воспринять
восток: востоке
восточн: восточной
восточны: восточные
времен: временем, времени
временн: временных
время: время
все: все
всеволод: всеволод, всеволода
всеволодович: всеволодович
всеволодовн: всеволодовна
всег: всего
всегд: всегда
всеславич: всеславича
всех: всех
всплеск: всплеск
всход: всходы
втор: вторая, второй
выделен: выделены
выступал: выступала
высш: высш, высшему
выш: выше
галин: галина
галицк: галицко
галицки: галицкий
гг: гг
где: где
георги: георгий
георгиев: георгиева
глав: главу
главн: главное, главной, главным
глубок: глубоко
говорят: говорят
год: года, году, годы
город: городов
городах: городах
горожан: горожан
государственн: государственно, государственный
государственност: государственности, государственность
грамот: грамота, грамоте, грамоты
грамотност: грамотности, грамотность
грамотны: грамотные
грече: греческих, греческое
греческ: греческой
григорьев: григорьевский
группов: групповое
гуманит: гуманит
гуманитар: гуманитарного
да: да
давалас: давалась
даж: даже
дал: дала, дали
два: два
двор: дворе
дворах: дворах
дворцов: дворцовая
девиц: девиц
девочек: девочек
дел: дела, дело
делах: делах
деньг: деньги
дет: детей, дети
детям: детям
деятел: деятели
до: до
добр: добрый, добрых
добровольн: добровольно
документ: документами
должен: должен
достаточн: достаточно
достоверны: достоверные
доход: доходы
доч: дочь
дошл: дошли
др: др
древ: древней
древн: древних
древнееврей: древнееврейских
древнерус: древнерусских
древнерусск: древнерусского, древнерусской
древност: древности
друг: других
духов: духовного
духовенств: духовенства, духовенство, духовенству
духовн: духовно
духовны: духовные
душ: душу
европ: европе
евфросини: евфросинии
евфросиния: евфросиния
его: его
единственн: единственным
ему: ему
желани: желание
жен: женское
живопис: живопись
живущ: живущих
жизн: жизни
жит: жить
житей: житейских
жител: жителей
заведени: заведением, заведений
заведения: заведения
завел: завел
завершил: завершил
задач: задача, задачей
заключительн: заключительная
закон: закон
заложил: заложил
занял: занял
занятиям: занятиям
зарождения: зарождения
зарубежны: зарубежные
заставил: заставил
зат: затем
затвор: затвор
защищат: защищать
здес: здесь
земл: земли
знакомств: знакомство
знаменит: знаменитое
знани: знаний
знания: знания
знатн: знатных
зодч: зодчему
идеал: идеала
из: из
изборник: изборник, изборника
известн: известно, известны, известных
изготовлен: изготовлен
изд: изд
изначальн: изначально
изображал: изображали
изображен: изображены
изучени: изучении
изучения: изучения
иисус: иисуса
им: им
имел: имел, имели
имелис: имелись
имен: именем
имеются: имеются
импульс: импульс
индивидуальност: индивидуальность
инициатор: инициатором
иностранн: иностранными
институт: институт
интеграци: интеграции
иным: иным
иоанн: иоанну
искусств: искусства
использовал: использовал
использоват: использовать
истори: истории
исторически: исторические
источник: источники, источников
их: их
кажд: каждого, каждый
казн: казны
как: как
камен: камень
каменн: каменная
кафедр: кафедра
качественн: качественный
киев: киеве, киевский
киевск: киевского, киевской
киевским: киевским
кирилл: кириллом
кириллиц: кириллицей
клет: клети
ключевы: ключевые
кн: кн
книг: книг, книгам, книгами, книги, книгой
книгах: книгах
книж: книжного
книжн: книжная, книжное, книжной, книжных
книжник: книжники, книжников
княже: княжеских
княжески: княжеские
княжеств: княжества
княжествах: княжествах
княжн: княжна
княз: князей, князем, князь
князя: князя
константин: константин, константином
констатирует: констатирует
конц: конца
котор: которого, котором, который, которых
которы: которые
краеугольн: краеугольный
красн: красное
кратк: краткой
крест: крест
крестил: крестил
крещени: крещении, крещению
крещения: крещения
кром: кроме
крупн: крупным
крупнейш: крупнейших
культур: культура, культуре, культуры
культурн: культурным, культурных
курск: курске
латин: латинских
легк: легкой
лет: лет
летопис: летописи
летописц: летописцы
литератур: литературы
литературны: литературные
лиш: лишь
лучш: лучших
люб: любого
любовь: любовью
любострасти: любострастие
люд: людей
магистр: магистр
мастерску: мастерскую
мастерств: мастерства
матер: матери
международ: международного
мертв: мертвых
местечк: местечке
местн: местных
мефоди: мефодием
мигрант: мигрантов
милосерди: милосердие
мир: мира
мирян: мирян
многи: многие
множеств: множество
могл: могли
могущественн: могущественный
молебн: молебна
молитв: молитва, молитвой
молод: молодых
монастыр: монастыре, монастырей, монастыри, монастырских, монастырское, монастырь
монастырски: монастырские
монастыря: монастыря
мономах: мономах
москв: москва
москов: московский
мстиславич: мстиславича
мудр: мудрого, мудрый
муром: муроме
навыкал: навыкал
навыкнут: навыкнут
названи: название
названн: названная
назидани: назидание
например: например
народ: народ, народа
нарочит: нарочитой
нас: нас
населения: населения
насельник: насельников
наставляет: наставляет
настойчив: настойчиво
научит: научить
научн: научных
националь: национального
национальн: национальное
начал: начала, начало
началас: началась
началос: началось
начальн: начальный
начин: начиная
начиналос: начиналось
ней: ней
нем: нем
немал: немало
неоднократн: неоднократно
ни: ни
никола: николай
них: них
нию: нию
нов: новой, новый
новгород: новгороде, новгородский
нравствен: нравственного
нравственн: нравственное
нуждающимся: нуждающимся
нужн: нужны
об: об
обездоленн: обездоленных
обильны: обильные
образ: образом
образовал: образовала
образовани: образование, образованию
образования: образования
образованност: образованности
образованны: образованные
образующим: образующим
образц: образцу
обращен: обращено
обучал: обучала
обучалис: обучались
обучени: обучение
обучения: обучения
обширны: обширные
обществ: обществе
овладени: овладению
овладет: овладеть
ок: ок
оказывал: оказывал
окол: около
окончани: окончании
олег: олегу
он: он
определенн: определенная
определил: определило
организовал: организовала
организован: организовано
освоени: освоению
осмомысл: осмомысл
основ: основе, основу
основал: основал, основала
основан: основан, основана
основани: основание
основны: основные
основоположник: основоположник
особенн: особенно
особы: особые
остальн: остальных
от: от
отдав: отдавая
отдават: отдавать
отече: отеческих
открывалис: открывались
открыл: открыл, открыла
открылас: открылась
открыт: открыть
открыти: открытии
открытия: открытия
отличи: отличие
отнош: отноше
отрасл: отраслей
отрок: отроков
отсюд: отсюда
отшельн: отшельни
павловн: павловна
памятник: памятники
пастыр: пастырей
педагог: педагоги
педагогик: педагогики
педагогиче: педагогический
педагогическ: педагогической
пени: пению
перв: первое, первой, первым
первоначальн: первоначальной
перву: первую
первы: первые
перевод: переводы
переводилис: переводились
переводчик: переводчики
переписк: переписке
переписчик: переписчики
переяслав: переяславский
переяславл: переяславле, переяславль
период: период, периода
писани: писаний, писанию
писател: писатели
письм: письмо, письму
письменн: письменном
письменност: письменности, письменность
плакал: плакали
повест: повести
поволж: поволжских
повышенн: повышенная
под: под
подготовк: подготовки
подготовлен: подготовлен
поднялас: поднялась
позволил: позволило
познал: познал
покаяни: покаяние
полезн: полезным
полн: полны
половин: половины
полоцк: полоцкая, полоцкого, полоцкой, полоцкому
получал: получали
получивш: получившего
получил: получили
помоч: помочь
помощ: помощь
поначал: поначалу
поняти: понятие
поручен: поручено
поручени: поручению
порядок: порядок
посадник: посадников
посл: после
послал: послал
пособи: пособие
пост: посте
потребност: потребности, потребность
потребовалос: потребовалось
поучени: поучение
почитани: почитанию
появлени: появление
прав: право
правил: правил
правител: правитель
правления: правления
православ: православного
православи: православие
православн: православное, православной
превратился: превратился
предания: предания
предел: пределами
предпосылк: предпосылки
предслав: предслава
представления: представления
предшествовал: предшествовало
прежд: прежде
премудрост: премудрость
преподават: преподавать
престол: престол
преступник: преступникам
при: при
приблизил: приблизили
прибыл: прибылей
приглашен: приглашены
признает: признает
призывает: призывает
принадлежит: принадлежит
принесенн: принесенная
принесл: принесло
принцип: принципы
приняти: принятие, принятием
принятия: принятия
приобретени: приобретением
приобщилас: приобщилась
приравнивалас: приравнивалась
притч: притчи
приходски: приходские
пришедшим: пришедшим
пробудил: пробудило
продолжил: продолжил
произведения: произведения
произошел: произошел
проповедник: проповедники, проповедников
просвещения: просвещения
прошл: прошли
проявляться: проявляться
псалтир: псалтирь
рад: рад
развиваться: развиваться
развити: развитии, развитию
разумет: разумети
раритетн: раритетными
распоряжени: распоряжению
распространени: распространение
распространения: распространения
распространяя: распространяя
рассказ: рассказ
рассмотрен: рассмотрены
рассчитанн: рассчитанная
расходилис: расходились
расходовал: расходовал
редакция: редакция
рекомендует: рекомендует
религ: религией
религиозн: религиозных
религия: религия
ремесл: ремеслам
родоначальник: родоначальник
рождественск: рождественском
роман: роман
росси: россии
российск: российского, российской
ростислав: ростислава
ростиславович: ростиславович
ростов: ростове, ростовский, ростовских
руках: руках
руководств: руководством
рус: руси, русская, русский, русских, русское, русь
русск: русского, русской, русском
русски: русские
рф: рф
ряд: ряде
садилис: садились
сам: самих, самого
самосознани: самосознание
самосознания: самосознания
сборник: сборника
св: св
свидетельств: свидетельства
сво: своей, своем, свои, своих, свою
своим: своими
святослав: святослав, святослава
святославич: святославич, святославича, святославичу
священник: священники, священников
священнослужител: священнослужителей
сделан: сделана
себя: себя
север: северо
сельц: сельцо
серьезн: серьезное
сирахов: сирахова
сирий: сирийских
сист: систему
систем: система, системы
славян: славяне, славянская
слез: слезы
слов: слова, словам, слове
служени: служением
смолен: смоленский
снисхождени: снисхождению
со: со
соб: собой
собират: собирать
собравш: собравши
собрал: собрал
собственн: собственно, собственной, собственных
совершенны: совершенные
совершит: совершить
советует: советует
содержал: содержал
содержани: содержание
содержащ: содержащей
соединив: соединив
создал: создала
создани: создание, создании, созданию
создания: создания
созданн: созданная
сокровищ: сокровищ
солнышк: солнышко
соломон: соломона
сооружени: сооружение
составил: составил
составленн: составленное
социальн: социально
сочинения: сочинения
спас: спаса
спасат: спасать
спасск: спасского
списках: списках
список: список
способствовал: способствовал
сраз: сразу
средств: средства, средство, средством
ставящим: ставящим
стал: стал, стала, стали, стало
старославян: старославянских
старши: старший
стать: статье
стен: стен
стенах: стенах
стремился: стремился
строил: строил
студ: студ
суздал: суздале
суздаль: суздальский
суздальск: суздальского
сум: сумев
существовал: существовала, существовали
существуют: существуют
сформировалас: сформировалась
сформировалос: сформировалось
считал: считало
считался: считался
сын: сын, сына
сынов: сыновей
табл: табл
так: тако
таки: такие
таким: таким
талантлив: талантливому
творческ: творчески
текст: текстов
тип: типе
тог: того
тогд: тогда
тольк: только
том: том, томов
торжеств: торжество
традиц: традициями
трех: трех
три: три
трудолюби: трудолюбие
трудолюбия: трудолюбия
туд: туда
тысяч: тысячу
уделял: уделял
уделялос: уделялось
уже: уже
указ: указу
умельц: умельцев
умертвят: умертвят
умнож: умножая
университет: университет
упоминается: упоминается
упоминания: упоминания
упоминают: упоминают
употребляться: употребляться
уровен: уровень
уровн: уровню
усвоени: усвоение
услови: условий
уст: устного
устроени: устроение
устройств: устройство
устрояем: устрояемы
утверждения: утверждения
учеб: учеб, учебного
учебн: учебной, учебным
учени: учение
ученик: ученик, ученикам, учеников, ученику
учения: учения
ученост: учености, ученость
ученость: ученостью
учень: ученье
училищ: училищ, училища, училище
учит: учить
учител: учителей
учиться: учиться
фигурк: фигурки
форм: форме, формой
формирования: формирования
фрагмент: фрагмент
функционировал: функционировали
храм: храмы
христиан: христианская
христианск: христиански
христиански: христианские
христианств: христианства, христианство, христианством
хронология: хронология
художественны: художественные
цел: цель
центр: центр, центрами, центром, центры
церкв: церкви
церквах: церквах
чад: чади
часосл: часослов
част: частей, часть
чег: чего
человек: человек, человека
человечески: человеческие
чем: чем
чернигов: чернигове, черниговский
честв: честве
числ: число
чтени: чтению
что: что
швени: швению
шевченк: шевченко
широк: широкое
школ: школ, школа, школу, школы
школь: школьного
элемент: элементами, элементом
элементарн: элементарное
эмалев: эмалевого
эстетическим: эстетическими
эта: эта
этап: этапы
этих: этих
это: это
этог: этого
ювелир: ювелирного
юност: юности
является: является
являлся: являлся
язык: языками
языческ: языческого
янк: янка
ярослав: ярослав, ярослава
ярославич: ярославич, ярославича
ярославович: ярославович, ярославовича
ярославск: ярославского
