абстракция: абстракция
академик: академик
академия: академия
активн: активно, активное
алесеев: алесеевский
амбулатор: амбулаторного
анализ: анализ
анатольевн: анатольевна
аннотация: аннотация
аптекарск: аптекарскому
ареал: ареал
арми: армии
армия: армия
археологическим: археологическим
батыя: батыя
бегал: бегали
белозёр: белозёрский
белозёрск: белозёрском
бескрайним: бескрайним
боле: более
болез: болезней
болезн: болезни
болел: болели
больн: больным, больными
больниц: больницы
больничны: больничные
боролас: боролась
будет: будет
будут: будут
был: была, были, было
быт: быт
бытов: бытовая
важн: важной, важным, важных
важну: важную
вассальн: вассальная
введени: введение
ведьм: ведьм
велик: великого
велся: велся
вест: вести
веществ: веществами
взаимодействует: взаимодействует
взят: взятого
вид: вид
википедия: википедия
власт: власть
влияни: влияние, влиянию
вмест: вместе
внедрялис: внедрялись
внимани: внимание
вод: водами
военн: военных
возможн: возможно
воинствующ: воинствующих
войск: войско
войсках: войсках
вокруг: вокруг
вопрос: вопрос, вопросам
восстановленн: восстановленных
вошл: вошла
впитывал: впитывала
врач: врачей
врачевания: врачевания
врачевател: врачевателями
времен: времен, времена, времени
время: время
все: все
всег: всего
всегд: всегда
всем: всем
всех: всех
всяческ: всяческого
выбран: выбранного
выбранн: выбранной
вывод: вывод
выгод: выгоды
выдающийся: выдающийся
выпускающ: выпускающих
высш: высшая
выход: выходом
выш: выше
гален: галена
галинов: галинова
гг: гг
где: где
гиппократ: гиппократа
главн: главной
глазах: глазах
говорил: говорил
говорит: говорить
говоря: говоря
год: год, году, годы
госпитал: госпиталей, госпитали
государств: государства, государство, государством
государственн: государственный
гражданск: гражданской
граничащ: граничащих
грече: греческих
давн: давних
даж: даже
дан: данного, даны, дань
данн: данной, данном
дат: дата, дату, дать
действи: действий
действия: действия
дел: делом
делис: делись
демонстраци: демонстрации
дискусси: дискуссии
дисциплин: дисциплин
довольн: довольно
документ: документом, документы
долг: долго
доп: доп
древнерусск: древнерусского
други: другие
духовн: духовная, духовной
духовны: духовные
его: его
едв: едва
ее: ее
елизавет: елизавета
емк: емкая
ест: есть
естественн: естественным
жертв: жертвой
живот: животного
жизн: жизни, жизнь
заболеваниям: заболеваниям
заведени: заведений
заведения: заведения
зависимост: зависимости, зависимость
завоевани: завоеваний
завоевател: завоевателей
задат: задать
заключени: заключение, заключению
заметит: заметить
зародилас: зародилась
захватчик: захватчиков
защит: защитой
земл: земле
знахар: знахари
значимост: значимость
золот: золотой
зря: зря
ибо: ибо
иван: иван
иго: иго
из: из
известн: известно, известное, известны
изд: изд
изучается: изучается
изучен: изучены
изучив: изучив
имеет: имеет
имел: имела
именн: именно
имеющ: имеющих
имеющиеся: имеющиеся
имеющим: имеющим
имеющихся: имеющихся
импер: империей
импери: империи
индийским: индийскими
ино: иное
интересн: интересный
иппократ: иппократа
искусств: искусство
использовалис: использовались
использовалос: использовалось
использования: использования
исследования: исследования
истори: истории, историю
историографи: историографии
историче: историческая
историческ: исторической
исторически: исторические
историческу: историческую
история: история
источник: источникам, источники
исход: исхода
их: их
кажду: каждую
как: как, какое, какой
картин: картины
картологическим: картологическим
качествен: качественного
кели: келии
киев: киево
кирилл: кирилло
кит: китая
ключев: ключевский
ключевы: ключевые
княжеств: княжеств
князья: князья
когд: когда
коем: коем
колдун: колдунов
комментари: комментарии
конгломерат: конгломерата
конечн: конечно
конкретн: конкретный
корень: кореньями
коренья: коренья
костомар: костомаров
котор: которого, которое, который
кочевник: кочевников
кратк: краткая
кром: кроме
крупн: крупное, крупных
кто: кто
культур: культура
культурн: культурная
курс: курс
лавр: лавру
лауреат: лауреат
лекар: лекари
лекарств: лекарства
лекарственн: лекарственными
лекарственны: лекарственные
лекарям: лекарям
летопис: летописи
лечени: лечение, лечении
лечения: лечения
литератур: литературы
литературны: литературные
лиш: лишь
люб: любая
любу: любую
люд: людей, люди
маз: мазями
мамонт: мамонтами
масштабн: масштабным, масштабных
масштабны: масштабные
материл: материл
медицин: медицина, медицине, медициной, медицинская, медицину, медицины
медицинск: медицинской
медицински: медицинские
медицинским: медицинским
межд: между
меньш: меньше
менялся: менялся
метод: методов, методы
механизм: механизм
мешающи: мешающие
многи: многие
многогранн: многогранна
могл: могла
можн: можно
момент: момент, моменты
монастыр: монастыре, монастырская, монастырь
монастырски: монастырские
монастырским: монастырским
монастырям: монастырям
монастырях: монастырях
монгол: монголами, монголией, монголо, монголов, монголы
монгольск: монгольской
монографи: монографии
москв: москва
московск: московского
набег: набегов
названи: названием
назначаются: назначаются
наиболе: наиболее
наибольше: наибольшее
найт: найти
нам: нам, нами
наместник: наместника
нападения: нападения
например: например
народ: народа, народного, народов, народом, народу
народн: народных
народност: народностей, народность
народны: народные
населявшим: населявшим
насон: насонов
насто: настоями
наук: наук, наука, наукой
научн: научная
находящийся: находящийся
началис: начались
наш: нашей, нашему, наши, наших
нашестви: нашествие
нашествия: нашествия
невозможн: невозможно
неготовность: неготовностью
ней: ней
нек: некая
некоторы: некоторые
нельзя: нельзя
немногочисленн: немногочисленной
необходим: необходимая, необходимо, необходимый, необходимым
непосредственн: непосредственно
неразрушенн: неразрушенных
несобранност: несобранность
ни: ни
никуд: никуда
ним: ним, ними
нобелевск: нобелевской
нов: новых
новы: новые
нормальн: нормально
обзор: обзор
област: области
обозначаем: обозначаемый
обозначит: обозначить
обозреваем: обозреваемой
образ: образ, образом
образовалос: образовалось
обратиться: обратиться
обращения: обращения
обрел: обрела
обширн: обширный
общ: общая
обыденн: обыденных
обыча: обычаи
обычн: обычный
оговорен: оговорено
одн: одной
однак: однако
одолевал: одолевали
оказани: оказание
оказания: оказания
оказывалас: оказывалась
олицетворял: олицетворяла
она: она
оно: оно
операци: операций
оперирования: оперирования
опиралас: опиралась
описав: описав
описан: описаны
описания: описания
определенны: определенные
опыт: опыт
организм: организм
орд: орды
основ: основу
основны: основные
основываться: основываться
особ: особое
осознават: осознавать
оставил: оставило
остается: остается
останавливалас: останавливалась
от: от
отвар: отварами
отдаленн: отдаленных
отечественн: отечественной
открывалис: открывались
открываются: открываются
отметит: отметить
отнест: отнести
относящиеся: относящиеся
отношени: отношении
отошл: отошла
отпечаток: отпечаток
отпор: отпор
отрасл: отрасль
отсталост: отсталости
оформилас: оформилась
охватывает: охватывает
охватывается: охватывается
очеред: очередь
павл: павлов
палат: палатам, палаты
перв: первого, первым
первы: первые
переведен: переведены
переживает: переживает
переживал: переживала
перейт: перейти
перенималис: перенимались
перераб: перераб
период: период, периода, периоде
петрович: петрович
печорску: печорскую
планируется: планируется
платит: платить
племен: племен
плод: плоды
плодотворн: плодотворно
плотн: плотно
повествования: повествования
повлиял: повлияло
погром: погрома
под: под
подвержен: подвержен
поддавалас: поддавалась
подробн: подробная
подтверждающи: подтверждающий
подчеркивается: подчеркивается
подъем: подъема
пожалу: пожалуй
познания: познания
пол: полного
политик: политика
политиканств: политиканством
политиче: политическая, политических, политическое
политическ: политической
политически: политические
политическим: политическим
полн: полной
полность: полностью
помим: помимо
помнит: помнить
помогл: помогло
помощ: помощи, помощь
понимат: понимать
порассуждав: порассуждав
посл: после
пособи: пособий
постепенн: постепенно
постоянн: постоянно
пот: потому
потребност: потребности, потребность
поэт: поэтому
правител: правителями
предк: предки
предоставит: предоставить
предоставлен: предоставлена
представлял: представляла
прежд: прежде
прежн: прежнему
преимущественн: преимущественно
преми: премии
преобразовавшихся: преобразовавшихся
при: при
привычк: привычки
привычн: привычный
приезжал: приезжали
прием: приемы
приказ: приказу
применяемы: применяемые
примечательн: примечательно
приостановк: приостановке
приходится: приходится
причин: причиной
проведени: проведении
проведя: проведя
продолжал: продолжали
продолжительн: продолжительный
произошл: произошло
происходил: происходил
происхождения: происхождения
промежуток: промежуток
просил: просили
прост: просто
простейш: простейших
простор: просторам
протекания: протекания
профессиональн: профессиональных
процентн: процентном
процесс: процесс
прошл: прошлого
развивалас: развивалась
развити: развитие
развития: развития
раздробленност: раздробленность
различн: различных
различны: различные
разн: разному
разобщенност: разобщенность
разрушен: разрушены
разумеется: разумеется
районах: районах
рамках: рамках
ранен: раненым, раненых
раненн: раненных
раскрыт: раскрыть
раскрытия: раскрытия
распространени: распространению
рассматривается: рассматривается
рассматриват: рассматривать
рассмотрен: рассмотрен, рассмотрено
рассмотрет: рассмотреть
ресурс: ресурсы
ровесниц: ровесница
род: рода
рол: роль
россий: российский
рус: руси, русская, русский, русь
русск: русской
русски: русские
русским: русским
рф: рф
ряд: ряд, ряде
саванн: саванны
сам: самих, само, самого, самых
самостоятельн: самостоятельно
светск: светской
сво: своей, свою
связ: связи
сделан: сделано
сделат: сделать
себ: себе
себя: себя
север: севере
северн: северных
сегодня: сегодня
сильн: сильный
симон: симонов
синтезироват: синтезировать
сказан: сказано
следующим: следующим
слов: слова
служил: служил
случа: случае, случаев
смежн: смежных
со: со
соб: собой
собирал: собирали
собрат: собрать
событи: событие, событием, событий
события: события
событиям: событиям
совершенн: совершенно
содержимы: содержимые
создани: создании
создания: создания
созданн: созданная
сообщающимися: сообщающимися
соответственн: соответственно
сорокин: сорокина
состав: состав, состава
состояни: состояние
состояния: состояния
состоящ: состоящая
социальн: социальная, социальный
спад: спада
спб: спб
список: список
сплотиться: сплотиться
способ: способы
способствовал: способствовало
сражения: сражения
сраз: сразу
средств: средства
ставши: ставший
стагнаци: стагнации
стади: стадии
стал: стал, стала, стали, стало
становлени: становление
становления: становления
стать: статье, статьи
стенах: стенах
стоит: стоит
стойк: стойко
стол: столь
сторон: стороны
стояни: стояние
студент: студент
сут: сути, суть
существовал: существовала
сущност: сущность
счита: считаем
считается: считается
тайг: тайга
так: такое, такой
таки: такие
татар: татар, татарский, татарское, татары
татарск: татарского, татарском
творящаяся: творящаяся
тем: тем, темы
тенденция: тенденция
теоретиче: теоретических
территори: территории, территорию
территориях: территориях
тибетск: тибетской
тог: того
тогд: тогда
тож: тоже
тольк: только
том: том
тот: тот
трав: травами
традиционн: традиционно
трансформировалас: трансформировалась
труд: трудам, труды
тюркск: тюркского
угр: угре
удастся: удастся
уделяется: уделяется
удоб: удобного
удовлетворит: удовлетворить
умирал: умирали
университет: университет
уничтожил: уничтожило
управляем: управляемое
уровн: уровне
усилия: усилия
условиях: условиях
установлени: установлением
устроенн: устроенный
уход: уход
уходил: уходила
уходит: уходит
учебн: учебных
учебник: учебник
учебны: учебные
учен: ученый
учреждения: учреждения
ушедш: ушедшая, ушедших
факт: факт, фактов
феодальн: феодальная
формируются: формируются
хан: хана, ханам
характеристик: характеристика, характеристики
ход: ходе
хот: хоть
хотя: хотя
хочется: хочется
храм: храмов, храмы
храмах: храмах
хронология: хронология
хрупк: хрупко
целител: целителей
цель: целью
центр: центр, центром
централизаци: централизации
централизация: централизация
церкв: церквей
церков: церковь
част: части
человек: человека
человече: человеческий, человеческих
человечеств: человечества
четк: четкого
читател: читателю
что: что
чуд: чудов
чут: чуть
широк: широко
широки: широкий
школ: школа
шла: шла
экономик: экономики
экономиче: экономическая
эмпириче: эмпирический
эпох: эпоху
эпохальн: эпохальных
эта: эта
этап: этапе
это: это
этог: этого
юрь: юрьев
явлени: явление
явления: явления
ярлык: ярлык
