абсолютно: абсолютно
абстракция: абстракций
авиация: авиацией, авиации, авиация
австралийский: австралийская, австралийскими
австрия: австрии
автор: авторы
авторитет: авторитетов
агрессивно: агрессивно
агрессивность: агрессивность
административно: административно
айдахо: айдахо
академия: академии
активный: активного
акцент: акцент
акцентировать: акцентировать
алгоритм: алгоритм
александрович: александрович
алкоголизм: алкоголизм
аллергический: аллергические
американский: американских
амстердам: амстердам
анализ: анализа
анализироваться: анализируется
английский: английском
андропов: андропов
анекдот: анекдоты
аннотация: аннотация
антрепренёр: антрепренёрами
антропогенный: антропогенные
армад: армад
аспект: аспекты
аста: аст
астрель: астрель
атака: атаки
атомный: атомных
баден: баден
баку: баку
без: без
беларусь: беларусь
бессмысленный: бессмысленных
благопристойный: благопристойное
благоприятный: благоприятный
близ: близ
блин: блин
боевой: боевых
божий: божий
болгарский: болгарская
более: более
болезненный: болезненных
больной: больное
больший: большая, большие, большими, больших
большинство: большинство
бомбардировка: бомбардировки, бомбардировок
бомбардировочный: бомбардировочная
бонза: бонз
борьба: борьбу, борьбы
бразилия: бразилия
бразильский: бразильская
будущий: будущих
буква: буква, буквы
буквальный: буквальном
бывать: бывает
быстро: быстро
быть: был, была, были, быть
бэйцзина: бэйцзин
важно: важно
вар: вары
вариант: варианте
варна: варна
варшава: варшавы
вблизи: вблизи
ведущий: ведущую
век: вв, век, века
великий: великого, величайшие
вена: вена, вене
венеция: венеция
вершина: вершина
весь: весь, всего, всей
весьма: весьма
ветвь: ветвь
вечный: вечный
взгляд: взгляд
вид: вида, виды
вино: вин
власть: власти
влияние: влияние
вместе: вместе
внг: внг
внутренний: внутренних
вовлечение: вовлечения
вода: воды
военный: военно, военной, военным, военных
вождь: вождями
воздух: воздухе
возлюбить: возлюбленной
возможность: возможности, возможность
возможный: возможный
возникать: возникает, возникают
война: войн, война, войны
войско: войск
вокруг: вокруг
вооружение: вооружений
вооружённый: вооружённых
вопрос: вопрос
ворота: воротами
воспринимать: воспринимаем, воспринимая
восприятие: восприятии
впервые: впервые
вполне: вполне
впоследствии: впоследствии
время: временам, времени, время
всегда: всегда
всё: все
второй: второй
вывод: вывод
выдающийся: выдающегося
выдумать: выдумал
выжить: выжить
выражаться: выражалось
выражение: выражению
высокий: высока, высших
высокопоставленный: высокопоставленных
высокоразвитый: высокоразвитой
вытекать: вытекающий
выход: выход
выяснить: выяснено
гарри: гарри
гатчина: гатчина
гвардия: гвардии
где: где
генерал: генералом
географически: географически
географический: географические, географических, географического, географическое, географической, географическую
география: географии, география
геополитический: геополитических
германия: германии
гибель: гибель
главный: главным
глубинка: глубинки
глядеть: глядя
говорить: говорил, говорим
год: годов, году
город: город, города, городами, городах, городов
городок: городок
городской: городских, городское, городской, городскую
горожанин: горожан
горький: горького
господство: господство
государственный: государственной, государственных
государство: государств, государства
гражданин: граждан
граница: граница
греча: греч
греческий: греческими
группа: группа
грязь: грязи
гумилёв: гумилёва
даже: даже
далее: далее
далёкий: далёкие
данные: данных
два: двумя
двадцатый: двадцатый
движение: движение
де: де
дебри: дебрях
девяностый: девяностых
действие: действий
дело: дел
демографический: демографического
демонтаж: демонтаж
деморализовать: деморализующего
день: дни
джулио: джулио
дислоцироваться: дислоцируются
длинный: длинным, длинными
днепропетровск: днепропетровска
до: до
довольно: довольно
доктрина: доктрина
должный: должен
доля: доля
доминирование: доминирование
достопримечательность: достопримечательностей
древний: древнего, древних
дрезден: дрездена
дропшота: дропшот
другой: другой
дубна: дубна
дубровник: дубровник
дух: дух
дуэ: дуэ
евпатория: евпатория
европа: европа
европейский: европейских
единственный: единственная, единственное
екатерина: екатерине
естественный: естественным
есть: есть
ещё: ещё
её: её
жанейро: жанейро
жертва: жертв
жизненный: жизненного
жизнь: жизни, жизнь
житель: жителей
жить: живут
заболевание: заболеваний
загрязнение: загрязнение
задавать: задаём
задача: задач
заключать: заключает
закрытость: закрытость
заметить: заметить
замысел: замыслы
занимать: занимала, занимают
заниматься: занимается
запад: запад
запоминаться: запоминающуюся
зачастую: зачастую
зачем: зачем
звуковой: звуковой
здесь: здесь
здоровый: здоровыми
зеландия: зеландии
земля: земле, земли, земля
земной: земного, земном
зиновьев: зиновьев
знаменитость: знаменитостей
значение: значение, значения
значительный: значительное, значительной
золотой: золотой
зрение: зрения
игорь: игорь
играть: играл, играя
идеал: идеалы
идейно: идейно
идеологема: идеологемам
идея: идеи
идти: шла
иерусалим: иерусалим
из: из
избирать: избирающие
известный: известна, известная
извратить: извращенным
издание: издание
изолированность: изолированность
изучать: изучают
изъясняться: изъяснялся
иллюзия: иллюзий
иметь: имевшего, имеет, иметь, имеют, имеющих
имманентно: имманентно
имя: имена, именами, именем, имя
инерционный: инерционная
иногда: иногда
иной: иного
инстинкт: инстинктам
интеграция: интеграции, интеграция
интенсивный: интенсивное
информация: информации
инфраструктура: инфраструктуры
исключительно: исключительно
исламабад: исламабад
исполнение: исполнения
использование: использование
исследовательский: исследовательских
исторический: исторический
история: истории
истощение: истощением
исчерпать: исчерпаны
итальянский: итальянским
итог: итогом
йорк: йорк
кадр: кадры
каждый: каждого
как: как
какой: какие
калашников: калашников
канберра: канберра
канд: канд
кара: кара
карлов: карловы
карта: карте, карту
касаться: касается
катастрофический: катастрофические
квалифицировать: квалифицированные
киев: киева
классик: классик
климат: климат
клиффорд: клиффорда
ключ: ключе
ключевой: ключевые
когда: когда
кожиновый: кожинов
кой: коих
коммунистический: коммунистического
комплекс: комплекс
комсомольский: комсомольский
конец: конца
констатироваться: констатировалась
конструкторский: конструкторских
концентрироваться: концентрируется
концепция: концепция
корифей: корифеи
кормиться: кормилось
короткий: короткими
корректный: корректным
корыстный: корыстных
который: которое, которой, котором, которые, которых
крайне: крайне
красногвардейск: красногвардейск
крестьянский: крестьянские
кризисный: кризисных
кроме: кроме
кронштадт: кронштадт
круг: круг
крупный: крупные, крупных
кстати: кстати
кугушева: кугушев
куйбышев: куйбышева
культура: культуре, культуры
курорт: курорты
курсант: курсант
курьёз: курьеза
ла: ла
ландшафт: ландшафтов
лев: льва
лежать: лежат
ленинград: ленинграда
лесной: лесных
лечебный: лечебно, лечебными
лечение: лечение
лидер: лидерами
лирично: лирично
литература: литературы
литературный: литературном
лицо: лица
личный: личный
лишить: лишат
лондон: лондон
лхаса: лхаса
любой: любое, любые
малоподвижный: малоподвижный
манера: манерой
манша: маншу
маргинальный: маргинальная
масса: массами
массировать: массированной
массовый: массовой
масштаб: масштабами
материал: материал
матрица: матрица
мафия: мафия
мвд: мвд
мгновенный: мгновенную
мег: мега
между: между
межнациональный: межнациональные
мекка: мекка
мельбурн: мельбурном
менее: менее
менять: меняли
меняться: меняющихся
мера: мере
местность: местность
место: места, место
метод: методами
механизм: механизмы
миграция: миграций, миграция
миллион: миллионов
миллионер: миллионеров
минеральный: минеральные
минск: минск
мир: мир, мира, мире
мирный: мирное
мировой: мирового, мировой, мировых
многие: многие
многий: многих
многое: многом
многократно: многократно
множество: множества, множество
мода: мода, моды
можно: можно
момент: момент
монополизировать: монополизируют
монтевидео: монтевидео
морской: морские, морском
москва: москва, москвы
москоу: москоу
мочь: могло, могут, может
мощный: мощным
мурза: мурза
мы: мы
мысль: мысли, мысль
навязывать: навязывают
нагасаки: нагасаки
надо: надо
название: название, названием, названии, названий, названия, названиями
называть: называемой
наиболее: наиболее
наименование: наименованиях
найти: найденного
налёт: налётов
намного: намного
например: например
напрячь: напряжённый
наркомания: наркомания
народ: народа, народов
народный: народной
население: население, населения
населить: населенные, населённых
населённый: населённые
насилие: насилие
настолько: настолько
наступать: наступает
насчитывать: насчитывало
натуральный: натуральных
наука: наук, наука, науке, науки
наукоград: наукограды
наумович: наумович
научно: научно
научный: научного, научных
находить: находящих
находиться: находится
национальный: национальной
начало: начала, начале
начать: начнём
наш: нашей, наши
неадекватно: неадекватно
неадекватный: неадекватном
небольшой: небольшой, небольшом
невозможно: невозможно
негативный: негативных
недоумевать: недоумевающие
нежелательно: нежелательно
неизбежно: неизбежно
некоторый: некоторые, некоторых
немецкий: немецкими, немецкое
неминуемый: неминуемый
немыслимый: немыслимой
необходимый: необходимой, необходимыми
неотъемлемый: неотъемлемыми
нервный: нервной
несостоятельный: несостоятельные
неуправляемый: неуправляемой
неуравновешенность: неуравновешенность
неустойчивый: неустойчив, неустойчивое
нечеловеческий: нечеловеческие
низкий: низкая
никакой: никакое
ницца: ницца
новый: нового, новой
нордау: нордау
норма: нормы
нужный: нужен
нынешний: нынешний
нью: нью
обеспечение: обеспечению
обитание: обитания
обитать: обитало
обладать: обладать, обладающая
область: область
обойтись: обошлось
обострять: обостряют
образ: образ, образом
образование: образовании
обстоятельство: обстоятельство
обусловливать: обусловливает
общение: общения
общественно: общественно
общественный: общественного, общественной, общественную
общество: общества, общество, обществу
общий: общее, общем, общий
объект: объект
обыватель: обыватель
обычный: обычными
ограничитель: ограничителем
огромный: огромных
одесса: одесса
один: одна
одинаковый: одинаковыми
одиночество: одиночества
однако: однако
означать: означают
оказание: оказания
оказать: оказали
океан: океана
окружающий: окружающий
окружение: окружении
октябрьский: октябрьский
он: его, он
они: их, них, они
оним: онима
онкологический: онкологические
оно: оно
опасный: опасной
опираться: опираясь
оправдание: оправдание
определённый: определенные, определённую
орган: органов
организация: организацию
осведомить: осведомлены
ослабить: ослабленный
основа: основе, основой
основать: основана
основное: основном
основный: основная
особенно: особенно
особо: особо
особый: особая, особого, особой, особом, особые, особых
останавливать: останавливающее
от: от
отголосок: отголоски
отдельный: отдельные
отказаться: отказаться
открывать: открывавшими
отличаться: отличалась, отличаются
отличительный: отличительной
отметить: отметить
отмечать: отмечал
отнюдь: отнюдь
отравить: отравят
отражение: отражение
офицерский: офицерского
охватывать: охватывают
охрана: охране
очаг: очаги
очень: очень
пакистанский: пакистанский
паломничество: паломничества
пари: пари
париж: париж
партийный: партийных
пассивный: пассивного
патологический: патологические
пекин: пекин
первый: первым
перевод: перевода
переводиться: переводится, переводятся
передача: передаче, передачи
переименовать: переименованные
переселение: переселение, переселении
переход: переход, перехода
период: период
петербург: петербург
петергоф: петергоф
петровский: петровскую
писать: пишем
план: планах
планета: планете
плоский: плоский
побережье: побережья
поведение: поведения
повторяться: повторяющихся
под: под
подавленность: подавленность
подготовка: подготовку
поддерживаться: поддерживаются
подобный: подобной, подобные
подразделение: подразделений, подразделения
подрыв: подрыва
позиция: позиции, позиция
покай: покаи
поколение: поколениям
полагать: полагают
полис: полисах, полисов
политизировать: политизированными
политический: политическая, политических, политического, политическую
полный: полное, полной
половина: половину
положение: положение, положении
пользоваться: пользуются
популяция: популяций
поражающий: поражающих
порождать: порождают
порт: порты
портовый: портовые, портовый, портовых
порядок: порядка
посему: посему
посередине: посередине
послевоенный: послевоенных
последний: последнее
посредственность: посредственности
постепенно: постепенно
постепенный: постепенным
построить: построенный
посёлок: поселков
потенциал: потенциала
потенциально: потенциально
потомок: потомки
почти: почти
почётный: почётное
появление: появления
правило: правило
правильно: правильно
правительство: правительства
правопорядок: правопорядка
практически: практически
превышать: превышало
предварительно: предварительно
предельно: предельно
предлагать: предлагают
предполагать: предполагали
предпочитать: предпочитают
предприятие: предприятий
преломление: преломлении
преобладать: преобладает, преобладающее
преступность: преступность
при: при
привилегированный: привилегированное
привычка: привычке
призвать: призваны
прийти: пришедшая
приложение: приложение
применение: применения
примечательный: примечательные
принцип: принципе
природный: природными, природных
приспособиться: приспособиться
пристально: пристально
пристрастие: пристрастие
присущий: присущи
притягивать: притягивают
причина: причин
проблема: проблем, проблемой
прогресс: прогресс
проект: проект
проектный: проектно
проживать: проживающих
прозвать: прозвали
произведение: произведения
производство: производства, производство
промысл: промыслах
промышленный: промышленного, промышленное, промышленных
прослойка: прослойка
проституция: проституция
просто: просто
пространство: пространства
протвино: протвино
протест: протеста
противник: противника
противодействие: противодействия
противоестественный: противоестественных
противоречие: противоречия
профессия: профессии, профессий, профессия
профилактический: профилактического
процесс: процессы
прочее: прочего
психический: психические
психологический: психологического, психологической, психологическом
пункт: пункт, пунктов, пункты
путешественник: путешественника
путь: пути
пущино: пущино
пятый: пятый
пёстрый: пёстрым
равновесие: равновесия
равный: равном
развитие: развитие, развития
разделение: разделение, разделения
разделять: разделяла
различный: различные, различных
разнообразный: разнообразных
разный: разных
разобщить: разобщены
разработать: разработанная
разработка: разработок
разрешить: разрешило
разрушение: разрушение, разрушением
разумеется: разумеется
рамка: рамках
ранее: ранее
раскатать: раскатанная
располагаться: располагаются
рассказать: рассказать
рассматривать: рассматривала
рассмотреть: рассмотреть
расстояние: расстоянии
расти: растет, рос
расширяться: расширяющееся
реальность: реальности
революция: революцией
режим: режима
резиденция: резиденции
резко: резко
река: реки
религиозный: религиозные
республика: республики
ресурс: ресурсов, ресурсы
речь: речи, речь
решать: решать
рим: рим
рио: рио
рипод: рипод
род: рода
родовой: родовые
рождать: рождало
роль: роль
рома: рома
роман: роман, романе
российский: российских
россия: россия
роттердам: роттердама
руина: руинах
русский: русские, русских, русской, русском
рф: рф
рыбинск: рыбинск
саймак: саймака
самолёт: самолетов
самый: самое, самые, самым
санкт: санкт
саратов: саратов, саратова
сведение: сведения
свердловск: свердловска
свет: свет, света, свете
свка: свки
своеобразный: своеобразный
свой: своего, своей, свои, своим, своими, своих, свой
связанный: связанные
сдвиг: сдвиги
сделать: сделан, сделать
себя: себе
сегодня: сегодня
седов: седов
седьмой: седьмые
сей: сей, сии
сельский: сельское
сергеевич: сергеевич
серьёзный: серьёзное
сидней: сиднеем
сие: сего
сила: сил, силу, силы
сингапур: сингапур
система: система, системой, системы
ситуация: ситуацию, ситуация, ситуациях
склад: склада
скученность: скученность
славой: славой
следовать: следует
следствие: следствием
слово: слова, словами
сложный: сложный
служить: служило
смысл: смысл, смысле
смысловой: смыслового, смысловой
собственный: собственных
событие: событиях
совершенно: совершенно
советский: советский, советских, советского, советской
современный: современной, современному
создаваться: создаются
создание: создания
сознание: сознания
сокращение: сокращение
соответственно: соответственно
соответствие: соответствии
сосредоточение: сосредоточения
сосредоточить: сосредоточено
состав: состав, состава, составом
составлять: составляет, составляют, составляющее
состояние: состояние
сотня: сотни
социально: социально
социальный: социального, социальные
социол: социол
социологизация: социологизация
социологический: социологической
социология: социологии
специально: специально
специальный: специальная, специальную
специфика: спецификой
специфический: специфические, специфических
список: список
сплочение: сплочения
спорный: спорную
способ: способа
среда: среде, среды
среди: среди
средство: средства, средствами
ссср: ссср
ставрополь: ставрополь
сталинград: сталинграда
становиться: становится, становятся
стародавний: стародавних
стать: стали, стать
статья: статье
степень: степень
стереть: сотрём
стимуляция: стимуляция
столица: столиц, столица, столицей, столицы
столь: столь
сторона: сторон
страна: стран, странах, страны
стратегический: стратегической, стратегическом
строительство: строительство
строиться: строились
сугубо: сугубо
суздаль: суздаль
сумасшедший: сумасшедшие
супер: супер
сутки: сутки
существо: существо, существу
существовать: существовало, существует, существуют
счёт: счёт
сша: сша
таков: таков, такова, таковы
такой: такие, таких, такого, такое
тактика: тактика
таллинн: таллинн
там: там
танковый: танковых
тауматауакатангиангакоауауотаматеапокануэиуакитаиатах: тауматауакатангиангакоауауотаматеапокануэиуакитаиатаху
тегеран: тегеран
телевидение: телевидение
тем: тем
тема: тему
тематеа: тематеа
темп: темпами
тенденция: тенденций
теоретик: теоретиком
теоретический: теоретических
терминология: терминологии
тесно: тесно
теснота: теснота
тесный: тесных
технический: технической
технологический: технологические
техрана: техран
течение: течения
тип: тип, типа
токио: токио
токё: токё
только: только
топоним: топонимов, топонимы
топонимика: топонимика, топонимики
топос: топос
торговец: торговца
торговля: торговле, торговля
тот: того, том, тому, тот
точка: точек, точка
точнее: точнее
традиционный: традиционного, традиционное
транспорт: транспорте
третий: третий
троицк: троицк
троцк: троцк
труд: труда
трудолюбивый: трудолюбивого
трумэн: трумэн
туризм: туризма
тысяча: тысяч
тёзка: тезки
увлечение: увлечение
увы: увы
углубление: углубление
удручающий: удручающее
указание: указание
указанный: указанные, указанных
укорениться: укоренились
уличный: уличное
ультрасовременный: ультрасовременных
умышленно: умышленно
уничтожение: уничтожение
упомянуть: упомянули
употребление: употребление
управление: управление, управления
управляемость: управляемости
уругвай: уругвая
усиливаться: усиливаются
условие: условия, условиями, условиях
устойчивость: устойчивости
уступить: уступил
участок: участке
учение: учения
учёный: ученые, ученый
учёт: учётом
уэнуа: уэнуа
фаза: фаза, фазе
факт: факт, фактах
фактор: факторы
фамилия: фамилиями
флейта: флейте
флитвуд: флитвуд
фонетический: фонетической
форма: форм
формировать: формируют
франция: франции
функция: функции, функций
характер: характера
характеризоваться: характеризуется
характерный: характерной
херсон: херсон
хиросима: хиросимы
хозяйство: хозяйства
хорошо: хорошо
хотя: хотя
хрупкий: хрупок
художественный: художественные
целое: целом
целый: целых
цель: цели, целью, целях
центр: центры
цивилизация: цивилизации, цивилизация
цивильный: цивильное
цифра: цифрах
чариотир: чариотир
часто: часто
часть: частей, части, часть, частью, частях
человек: людей, люди, людьми, человека
человечество: человечества
череда: череда
через: через
черноголовка: черноголовка
черта: чертами, чертой, черты
чешский: чешские
число: числе, число
чисто: чисто
членкор: членкор
чрезвычайный: чрезвычайное
что: что, чём
чувство: чувств, чувство
шанхай: шанхай
шар: шара, шаре
шведский: шведский
шестьдесят: шестидесяти
широкий: широкий
широко: широко
шлиссельбург: шлиссельбург
штат: штат
шум: шум
щербаков: щербаков
экономический: экономическая, экономического, экономической
экскурс: экскурс
эксмо: эксмо
элемент: элемента
элитарий: элитарий
эмоционально: эмоционально
эпоха: эпоху
этнический: этнический, этническим, этническими
этнос: этноса
это: это, этого, этом
этот: эта, эти, этих, этой
явление: явление
являться: является, являлось, являются
язык: языка
языкознание: языкознания
ясно: ясно
ястреб: ястребов
яуза: яуза
