автор: автором
алюнин: алюнина
аннотация: аннотация
анонимн: анонимная
атлас: атласом
бабушк: бабушка
бежал: бежали
безносов: безносова
безусловн: безусловный
белы: белые
бесед: беседа
бесчисленн: бесчисленными
бодрилас: бодрилась
боле: более
больш: большая, больше, большой
брал: брал, брали
брат: брата, братская, брать
брон: бронь
будуч: будучи
был: был, была, было
быстр: быстро
быт: быть
валентин: валентина
вдовол: вдоволь
везд: везде
велик: великая
взросл: взрослое, взрослых
видим: видимо
вит: витю
витальевн: витальевны
вклад: вклад
владимир: владимир
власт: власть
вмест: вместе, вместо
внимания: внимания
внёс: внёс
вов: вов
вод: водой, воду
воевал: воевал
военн: военное, военном
возвращалас: возвращалась
возьмет: возьмет
войн: война, войны
волод: володе
воспитани: воспитанию
воспитывал: воспитывала
воспоминан: воспоминаниями
воспоминани: воспоминанием
воспоминания: воспоминания
врач: врача
времен: времена, временем
время: время
все: все
всегд: всегда
всем: всем
всех: всех
встал: встали
встреч: встреча
всё: всё
вчерашни: вчерашние
выбежал: выбежали
выбирал: выбирали
вывод: вывод
выдавал: выдавали
выделил: выделили
выживал: выживали
выйдеш: выйдешь
выкорчевывал: выкорчевывала
выменят: выменять
вынесут: вынесут
высвобождат: высвобождать
выступал: выступали
выход: выходе
вязат: вязать
гаврил: гаврилов
где: где
германи: германию
гибнет: гибнет
гитлеровску: гитлеровскую
глубж: глубже
говорят: говорят
год: год, года, годом, году, годы
годах: годах
голодн: голодным
горбольниц: горбольница
горяч: горячего
государственн: государственный
готов: готовы
граждан: граждан
грамм: граммов
григорьевн: григорьевна, григорьевну, григорьевны
да: да
давал: давали
даж: даже
далек: далеко
дальш: дальше
данн: данной
дар: даров
дво: двое
двумя: двумя
девушк: девушку
делиться: делиться
делян: деляну
деньг: деньги
дерев: деревом
деревен: деревенская
дет: детей, дети, детский, детских
детск: детском
детств: детстве, детство
детьм: детьми
детям: детям
длинн: длинным
дне: дней
днем: днем
дням: днями
до: до
дожидаяс: дожидаясь
дом: дом, дома
дорог: дорогам, дороге
досталас: досталась
дочер: дочери
драк: драки
друг: друг, друга, других
думал: думала
дядя: дядя
его: его
еду: еду
еды: еды
ее: ее
ездил: ездила
еланц: еланцы
ему: ему
ершов: ершова
ещё: ещё
её: её
жалея: жалея
ждал: ждали
железн: железной
женщин: женщин, женщины
живущ: живущая
жизн: жизнь
жил: жили
жит: жить
забайкаль: забайкалье
завод: заводы
задержалас: задержалась
закончил: закончила
закончит: закончить
замуж: замуж
запоминающимся: запоминающимся
запретил: запретили
застал: застала
затронул: затронула
зачасту: зачастую
защит: защиту
земл: землю
знал: знали
знат: знать
значит: значит
игрушек: игрушек
из: из
изб: изба, избе
изнутр: изнутри
иногд: иногда
интерес: интерес
иркут: иркутский
иркутск: иркутск
исследовател: исследователей
истори: истории
историче: историческая, исторических
история: история
источник: источников
их: их
каблучк: каблучки
кажд: каждым
как: как
картофелин: картофелин
карточк: карточкам
картошк: картошка, картошкой
кафедр: кафедра
кин: кино
ключевы: ключевые
кнут: кнут
когд: когда
компан: компаниями
конкретн: конкретных
конц: концу
коньк: коньки
кор: коров
кормил: кормили
кормилиц: кормилицы
кормит: кормить
коровушк: коровушку
котор: которая, которого, котором, который
котору: которую
которы: которые
краж: краж
крас: красного
крик: криком
кричал: кричали
кроил: кроила
кружк: кружку
кто: кто
кувшин: кувшином
куйтунск: куйтунского
куск: куски
кусок: кусок
лежал: лежало
лезви: лезвий
лезвия: лезвия
ленинград: ленинградом
лет: лет, летом
лиди: лидии, лидию
лидия: лидия
липким: липким
литератур: литературы
лицеват: лицевать
личн: личная
лиш: лишь
лишил: лишили
ловл: ловли
лом: ломая
лучши: лучший
лучшим: лучшим
льд: льда
любов: любовь
люд: людей, люди
лёгк: лёгкое
магазин: магазин
маленьк: маленьких, маленькому
мам: мама, маму
мамин: мамина, мамины
мат: мать
матер: матери
материальн: материальных
матерь: матерью
мене: менее
меня: меня
мест: места, место
мим: мимо
мирны: мирные
младш: младшей
младши: младшие, младший
мне: мне
мног: многих
многи: многие
многодетн: многодетной
множеств: множество
могут: могут
может: может
можн: можно
молоду: молодую
молок: молока, молоко
момент: моментом
мостовщиков: мостовщикова
мотат: мотать
моя: моя
мужчин: мужчины
мук: муку
мы: мы
мяч: мяча
наглядн: наглядными
над: над
наказ: наказ
накатавшис: накатавшись
накормил: накормили
накосил: накосила
накрученны: накрученные
нам: нам
народ: народа
нас: нас
населени: население
нахлынувш: нахлынувших
находился: находился
начал: начало
началас: началась
наш: наших
нашёл: нашёл
невзгод: невзгод
невзлюбил: невзлюбила
невозможность: невозможностью
нег: него
недовольств: недовольству
незабвенн: незабвенным
ней: ней
некотор: некоторыми
непосредственн: непосредственными
непропечённ: непропечённый
нескольк: несколько
несмотря: несмотря
нет: нет
нецелованн: нецелованным
неё: неё
ни: ни
нибуд: нибудь
николаевн: николаевна
нит: нити
ног: ноги
нож: нож
носил: носил, носили
ноч: ночам, ночи
ночь: ночью
ноября: ноября
нужд: нужды
обед: обед
обеспечив: обеспечивая
област: области
облизат: облизать
облизнул: облизнул
обработк: обработки
образ: образом
обшит: обшито
обыскивал: обыскивали
обычн: обычно, обычных
огромн: огромный
огромны: огромные
один: один
одн: одна, одни, одних, одно, одного, одной
однажд: однажды
однак: однако
ожидал: ожидали
оказалас: оказалась
окн: окна
окол: около
октябр: октябре
октябрин: октябрина, октябрину
оловянн: оловянная
ольхонск: ольхонского
он: он
она: она
они: они
оно: оно
опрошен: опрошенного
опрошенн: опрошенных
освещени: освещению
осень: осенью
оставалис: оставались
осталас: осталась
осталис: остались
осталося: осталося
остановил: остановили
остатк: остатки
остаётся: остаётся
от: от
отапливат: отапливать
ответ: ответ
отец: отец
отечественн: отечественная
открылся: открылся
отнималис: отнимались
отобрал: отобрала
отправил: отправили
отпускал: отпускали
отсутствия: отсутствия
отход: отходы
отц: отца
очевидц: очевидцами
очен: очень
павлович: павлович
пальт: пальто
памят: память
пантелеевн: пантелеевна
пап: папа, папы
патриотическ: патриотическому
пахл: пахло
пекл: пекли
перв: первых
переехал: переехала
переживш: переживших
перенесл: перенесли
перешит: перешить
период: период, периоде
пискарёвск: пискарёвском
письм: письма, письмами
плакал: плакали
плать: платье
плеч: плечи, плечом, плечу
побед: победа, победе, победу, победы
победивш: победившего
повел: повели
повинны: повинные
погреться: погреться
под: под
подарил: подарили
подвиг: подвиг
поделилас: поделилась
подлинн: подлинных
подоконник: подоконнике
подпаск: подпаском
подростк: подростки
подскаж: подскажи
позволяют: позволяют
позж: позже
пок: пока
покинут: покинуть
положительн: положительных
полотн: полотна
получался: получался
помешал: помешало
помим: помимо
помн: помню
помнит: помнит
понял: поняла
понят: понять
попал: попал
пор: пор
портрет: портрет
посадил: посадили
посадит: посадить
поскольк: поскольку
посл: после
послевоенн: послевоенное, послевоенных
послевоенны: послевоенные
последним: последним
пострадал: пострадали
посылк: посылка
посёлк: посёлку
пот: потом, потому
потер: потерями
потихонечк: потихонечку
походк: походку
похоронк: похоронка
почистил: почистил
почтальон: почтальон
почувствоват: почувствовать
пошёл: пошёл
поэт: поэтому
появившийся: появившийся
появился: появился
прав: право
пред: предам
предк: предков
предоставлен: предоставлены
предотвращения: предотвращения
представляют: представляют
прекратится: прекратится
препятствия: препятствия
при: при
приведен: приведены
привел: привела
придумывал: придумывали
прикрепил: прикрепила
прилип: прилип
природ: природы
приходилос: приходилось
пришл: пришла
пришлос: пришлось
проблем: проблема
проведен: проведена
проводил: проводили
продавал: продавал
продпункт: продпункте
проезжал: проезжали
производств: производства
пропитания: пропитания
просил: просили
прост: простых
просыпался: просыпался
протяжени: протяжении
пятн: пятна
работ: работу, работы
работал: работал, работала
работат: работать
работник: работников
рабочи: рабочие
радост: радостей
раз: раз
развлечения: развлечения
разны: разные
разошлис: разошлись
район: района
рамках: рамках
раскладывал: раскладывала
рассказ: рассказ
растил: растила
ребёнк: ребёнка
регин: регины
ржан: ржаной
родившаяся: родившаяся
родин: родины
родител: родители
родителям: родителям
рождён: рождён
рол: роли
росси: россии
рубашк: рубашке
руках: руках
рф: рф
рыб: рыбы
рыбзавод: рыбзавод
рыдал: рыдала
рынок: рынок
сад: сад, садов, саду
сам: сама, сами, самым, самыми
сапог: сапоги
сахар: сахар, сахара
свалившиеся: свалившиеся
свалк: свалке
свет: свет, свете
свидетельств: свидетельствами
сво: свои, свой, свою
своим: своими
связ: связи
сгорел: сгорел
сделал: сделала
сделат: сделать
себ: себе
себя: себя
сей: сей
сейчас: сейчас
секунд: секунду
сел: села, селе
семь: семье, семьи, семью
семья: семья
сен: сено
сентября: сентября
серьг: серьга, серьгу
сестр: сестра, сестре, сестры
сет: сети
сидел: сидела, сидели
сидет: сидеть
сидя: сидя
сих: сих
сказал: сказала
следовал: следовал
следующим: следующим
слов: слова
слыл: слыл
сначал: сначала
снег: снега
снял: сняла
со: со
соб: собой
собеседник: собеседником
собират: собирать
собрал: собрала
совс: совсем
совхоз: совхозе
сожгл: сожгла
солдат: солдат
состоящ: состоящей
сохранилос: сохранилось
спал: спала, спали
спасён: спасён
спешат: спешат
список: список
спустя: спустя
ст: ст
стал: стал, стала, стали
старш: старшая, старше
стать: статье
стихотворени: стихотворением
стол: столе, столом
столов: столовой
стран: страны
строчк: строчки
студент: студент
стучат: стучат
судьб: судьбы
сумк: сумку
сумках: сумках
суровы: суровые
сшил: сшила
съедал: съедал
съестн: съестное
сытн: сытно
та: та
таким: таким
там: там
танк: танк
тарасун: тарасуна
таскал: таскали
те: те
тем: тем, теме, темы
территори: территории
тиш: тиши
тогд: тогда
тож: тоже
тольк: только
том: том
тот: тот
травк: травки
трактор: трактору
трактористк: трактористка
требует: требует
тро: трое, троих
троим: троими
трудяс: трудясь
труженик: труженики
тряпк: тряпки
тыл: тыла, тылу
тюрьм: тюрьму
тягот: тягот, тяготы
тяжел: тяжелое
тяжёлы: тяжёлые
тёпл: тёплой
тётя: тётя
уделяется: уделяется
удэ: удэ
уже: уже
узнал: узнала
указывает: указывает
украл: украли
улан: улан
улиц: улицу
ульян: ульяна
умени: умение
умерл: умерла
университет: университет
ура: ура
урожа: урожай
успел: успела
устраивал: устраивали
утр: утра
уходил: уходил
участник: участниками
училас: училась
ушёл: ушёл
фадин: фадина, фадиной
факт: фактов
фашизм: фашизм, фашизмом
федя: федя
флаг: флаг
фронт: фронт, фронта
футболь: футбольного
хаихт: хаихта
хватал: хватало
хлеб: хлеб, хлеба, хлебом
ходил: ходили
холодн: холодно
хот: хоть
хотелос: хотелось
хрупки: хрупкие
хуж: хуже
цел: целыми
ценност: ценностей
час: часов
чая: чая
человек: человека
чем: чем
через: через
четвер: четверо
чистил: чистил
читинск: читинской
что: что
чут: чуть
чём: чём
шел: шел
шил: шила
широк: широком
шит: шить
школ: школе
школьник: школьники
шла: шла
эдуардовн: эдуардовна
эмоци: эмоций
эпох: эпохи
эти: эти
это: это
этом: этом
эшелон: эшелон, эшелоны
юны: юные
являяс: являясь
язык: язык, языком
ярким: ярким, яркими
