абхаз: абхазией
абхази: абхазии
август: августа, августе
акт: актами
актив: активного
активн: активным
акцент: акцент
акцентировал: акцентировали
акциях: акциях
аланович: аланович
анализ: анализ
аннотация: аннотация
арен: арене
асад: асадов
базза: баззаев
баран: баранов
безопасност: безопасности
бизнес: бизнесом
ближн: ближнего
больш: больше
брикс: брикс
был: был, были, было
бюрократизироваться: бюрократизироваться
важност: важность
валентин: валентина
ведется: ведется
взаимн: взаимно, взаимной
взаимодействи: взаимодействии
взаимодействия: взаимодействия
взамен: взамен
взгляд: взгляд
власт: власти
властн: властных
влияни: влияние
влият: влиять
влияя: влияя
влксм: влксм
вмест: вместо
внешнеполитиче: внешнеполитических
внимани: внимание
внутриэкономиче: внутриэкономических
вовлечени: вовлечении
военн: военно, военной, военных
возможност: возможности, возможность
возраст: возрасте
войн: войн
волонтерск: волонтерской
вооружен: вооруженного
вооруженн: вооруженными
вопрос: вопрос, вопросов
воспитани: воспитание
воспитания: воспитания
времен: времени
время: время
все: все
всем: всеми
всех: всех
вследстви: вследствие
встал: встал
всю: всю
вуз: вузами
вузовск: вузовского
вывод: выводы
выделяются: выделяются
выполнял: выполняла
выполнят: выполнять
выстраивают: выстраивают
высш: высшего
высше: высшее
высши: высший
вышел: вышел
гатикоев: гатикоева
где: где
говорит: говорить
год: года, годов, году, годы
годах: годах
город: городе
государствен: государственного
государственн: государственной, государственном, государственный
государственност: государственности
государственны: государственные
граждан: граждан, гражданских
гражданску: гражданскую
грузин: грузино
грузинск: грузинского
гуманитар: гуманитарного
гуманитарн: гуманитарное, гуманитарной, гуманитарному
дав: давая
дает: дает
данн: данный
данны: данные
дат: дата
двусторонн: двусторонних
двух: двух
действия: действия
декларация: декларация
дел: дел, делая
делается: делается
демографи: демографии
ден: день
деятельност: деятельности
деятельность: деятельностью
диплом: дипломы
дипломатиче: дипломатических
днр: днр
до: до
добивалас: добивалась
договор: договор
документ: документ, документа, документе, документов, документы
долгосрочны: долгосрочные
должност: должности
донецк: донецкой
дополнен: дополнениями
доступ: доступа
другим: другими
дружб: дружбе
духов: духовного
евразия: евразия
его: его
ельцин: ельцина
жизн: жизни, жизнь
журнал: журнал
задач: задачей, задачи
заключен: заключены
закон: закон, законом, закону
законодател: законодателей
закрепивши: закрепивший
занималос: занималось
занимат: занимать
заниматься: заниматься
занятост: занятости
западн: западными
зарубежн: зарубежных
зарубежья: зарубежья
знает: знает
из: из
изменен: изменениями
изучат: изучать
изучени: изучение
им: им
именн: именно
инвестици: инвестиций
инициатив: инициативу
институциональны: институциональные
интеграция: интеграция
интерес: интересы
интересах: интересах
испытывал: испытывала
исследовани: исследований
истори: истории, историю
история: история
кавказоведения: кавказоведения
кадров: кадровой
как: как
катализатор: катализаторами
кафедр: кафедры
ключев: ключевыми
ключевы: ключевые
комитет: комитета
коммунистическ: коммунистической
комплекс: комплекса
комплексн: комплексная
конкурсах: конкурсах
консолидаци: консолидацию
конституц: конституцией
консультаци: консультаций
контекст: контексте
конференциях: конференциях
конфликт: конфликта, конфликтами
конц: конца
концепци: концепции
концепция: концепция
корн: корне
котор: которая, которое, котором
кпсс: кпсс
кризис: кризис
кругл: круглого, круглых
крупн: крупных
крушения: крушения
культур: культуре, культурного, культуру, культуры
лагерях: лагерях
лет: лет
литератур: литературы
лнр: лнр
локус: локус
луганск: луганской
льготник: льготников
люд: людей, люди
мансур: мансуров
массов: массово
материал: материалов
мая: мая
медицинску: медицинскую
межвузовск: межвузовского
межд: между
международ: международного
международн: международная, международное, международной, международном, международных
меняется: меняется
меняюще: меняющее
мер: мер, мерой, меры
мерах: мерах
мероприяти: мероприятий
мероприятиях: мероприятиях
мест: месте
мид: мид
министерств: министерств, министерства, министерство
министр: министров
мировоззрения: мировоззрения
мног: многое
мобилизационн: мобилизационных
может: может
можн: можно
молод: молодого, молодых
молодеж: молодежи, молодежного, молодежь
молодежн: молодежная, молодежной, молодежных
момент: момент
москв: москве, москвы
муниципальн: муниципальных
мы: мы
наибольшу: наибольшую
наметилис: наметились
направленн: направленная
народн: народных
населения: населения
наследи: наследию
настояще: настоящее
настоящим: настоящим
наук: науки
науч: научного
научн: научно, научными, научных
националь: национального
национальн: национальной, национальных
национальны: национальные
начинает: начинает
наш: наша
нег: него
независимост: независимости
необходим: необходима, необходимых
непрерывн: непрерывно
непросты: непростые
несмотря: несмотря
никола: николай
нич: ничего
нов: нового, новой, новый, новым
новы: новые
нормативн: нормативно
ноябр: ноябре
нынешню: нынешнюю
об: об
обе: обеих
обеспечения: обеспечения
обеспечивается: обеспечивается
област: областей, области
облисполк: облисполком
обмен: обмена, обмену
образ: образом
образовалис: образовались
образовани: образование, образовании
образования: образования
образовательн: образовательных
образовательну: образовательную
обращения: обращения
обстановк: обстановки, обстановку
обсудил: обсудили
обсуждени: обсуждением
обучени: обучение
обществ: общество
обществен: общественного
общественн: общественно, общественных
общи: общие
объединени: объединений
объединения: объединения
однак: однако
оказалос: оказалось
они: они
оон: оон
описанн: описанный
орган: органов
организац: организациями
организаци: организации, организаций
организационн: организационно
организованн: организованная
организовывают: организовывают
осет: осетией
осети: осетии
осетин: осетино, осетинский, осетинских
осетинск: осетинского, осетинской, осетинском
осетински: осетинские
осетия: осетия
основ: основы
основанн: основанных
особенност: особенности
от: от
отдельн: отдельных
открылся: открылся
отношени: отношение, отношений, отношению
отношения: отношения
отстаивания: отстаивания
официальн: официальный, официальных
парти: партии
партнер: партнером
патриотизм: патриотизма
патриотиче: патриотических
патриотическ: патриотического
патриотически: патриотические
перв: первый
первоочередн: первоочередных
переговор: переговоры
перестал: перестал
переходя: переходя
перечня: перечня
перспектив: перспективы
план: плане
плотн: плотных
поддержани: поддержание
подписан: подписан, подписаны
подход: подходы
позволяют: позволяют
позици: позицию
поколения: поколения
политик: политика, политике, политики, политикой, политику
политиче: политических
политическ: политической
политически: политические
полноправн: полноправным
положени: положение
положительн: положительно
получат: получать
получени: получением
помощ: помощи, помощь
понимани: понимании
популяризаци: популяризацию
посл: после
последни: последние
постепенн: постепенно
постсоветск: постсоветском
появилос: появилось
прав: права
правов: правовыми
правовы: правовые
практиче: практический
практическ: практически
предк: предков
предлагает: предлагает
предложит: предложить
предполагает: предполагает
предполагается: предполагается
предполагающи: предполагающие
представител: представители
представленн: представленной
представля: представляем
прежн: прежних
президент: президента
прекращения: прекращения
преобразовани: преобразований
преподавани: преподавание
преподавания: преподавания
преподавател: преподаватель
привел: привело
привлечени: привлечение, привлечению
приграничн: приграничных
призванны: призванные
признан: признаны
признани: признание
признания: признания
принимает: принимает
принимается: принимается
принят: принятая
приняти: принятие, принятием
приняты: принятые
приобретает: приобретает
приоритетн: приоритетной
проблем: проблемы
проведени: проведение
проведения: проведения
проводится: проводится
программ: программа, программы
продвижени: продвижение
продолжат: продолжат
проект: проектам, проекты
происходил: происходило
происходящ: происходящей
пространств: пространстве
противореч: противоречиями
протяжени: протяжении
процесс: процессов
прошедш: прошедшем
прошедши: прошедшие
проявляет: проявляет
проявлят: проявлять
проявляя: проявляя
работ: работе
развив: развивая
развивалис: развивались
развития: развития
различн: различных
рамках: рамках
распространяя: распространяя
рассматриваются: рассматриваются
расширения: расширения
расширят: расширят
реализация: реализация
реализуется: реализуется
региональн: региональном
режим: режим
резк: резкое
результат: результате
республик: республик, республика, республике, республики, республикой
ресурс: ресурс
реформировани: реформирование
решающим: решающим
решен: решены
рол: роли
росмолодежь: росмолодежью
росс: россией
росси: россии
россий: российский, российских, российское
российск: российско, российской
россия: россия
рубеж: рубежом
русск: русского, русском
русску: русскую
рф: рф
рюо: рюо
сайт: сайт
сближения: сближения
сверстник: сверстниками
сво: свои
своевременн: своевременной
своим: своими
связ: связей, связи
связанн: связанных
северн: северной
сегодняшни: сегодняшний
сем: семей
семейн: семейных
сентября: сентября
систем: системе, системы
сказат: сказать
сказывается: сказывается
слаб: слабо
сло: слоем
слов: слова
сложност: сложности
служб: службы
сми: сми
смысл: смыслы
снг: снг
со: со
собственн: собственной
собственны: собственные
совет: совета, совете
советск: советского
совместны: совместные
совмещения: совмещения
современн: современном
современны: современные
согласн: согласно
соглашения: соглашения
содействи: содействие
создан: созданы
создани: создание, созданию
создаются: создаются
сопредельн: сопредельных
соревнованиях: соревнованиях
сотрудничают: сотрудничают
сотрудничеств: сотрудничества, сотрудничестве, сотрудничество, сотрудничеству
сохранени: сохранению
сохранит: сохранить
социальн: социальной, социальных
социальны: социальные
союз: союза
специфически: специфические
список: список
спорт: спорт, спорта, спорту
спортивн: спортивных
сред: среда, среды
ссср: ссср
стал: стало
становится: становится
старши: старший
стать: статье
стипенди: стипендии
стоит: стоит
стол: стола
столах: столах
сторон: сторон
стран: стран, странами
строя: строя
структур: структур
студент: студентов
студенче: студенческих
суверенитет: суверенитета
сфер: сфере, сферу
сферах: сферах
так: такой
таким: таким, такими
там: там
творчески: творческие
тем: тему
тенденци: тенденции
территори: территорий
территориальн: территориальной
территориях: территориях
тесн: тесно, тесное
технически: технические
тибилов: тибилова
тогд: тогда
том: том
тот: тот
традици: традиции
традиционн: традиционных
традициях: традициях
требовал: требовали
туризм: туризм, туризма, туризму
уделяется: уделяется
уделял: уделяли
уже: уже
узнат: узнать
указ: указ
укреплени: укрепление
университет: университет, университета, университете
управленче: управленческих
упразднен: упразднен
уровен: уровень
уровн: уровне
усилилос: усилилось
услови: условий
условиях: условиях
устанавливающим: устанавливающими
установления: установления
участи: участием, участии
участия: участия
учебник: учебникам
учитыват: учитывать
ушедш: ушедшей
факт: факт
федеральн: федеральном
федераци: федерации
физическ: физического
финансировани: финансированию
формальность: формальностью
формировани: формирование
форум: форум, форуме
форумах: форумах
функци: функции
ход: ходе
цел: цели
целостност: целостности
цен: цену
ценност: ценностей
центр: центр
цхинвал: цхинвал, цхинвала, цхинвале
част: часть
частн: частных
часть: частью
чем: чем
черт: черты
числ: числе
что: что
шестнадцат: шестнадцати, шестнадцать
школь: школьного
школьник: школьников
шос: шос
электронн: электронный
этап: этапе
этих: этих
это: это
эту: эту
эффективн: эффективно
юго: юго
югоосетинск: югоосетинскому
южн: южная, южной
является: является
являлис: являлись
являющиеся: являющиеся
язык: язык, языка, языке
