август: августа
административн: административной
академик: академика
академически: академические
аксенов: аксенова
актив: активного
активизировалас: активизировалась
активн: активное
актуальн: актуальным
александр: александром
александров: александровская
альт: альтов
анализ: анализ, анализа
ангелин: ангелина
аннотация: аннотация
антич: античного
арочны: арочные
архитектор: архитекторам, архитектором
архитектур: архитектура, архитектуре, архитектурного, архитектуры
архитектурн: архитектурное, архитектурном, архитектурный, архитектурным, архитектурных
архитектурны: архитектурные
аспект: аспекты
аттик: аттик
барокк: барокко
башкир: башкиров
боле: более
больш: большой
большинств: большинстве
будущ: будущего
бурна: бурнаев
бывш: бывшей
был: был, была, были, было
быстр: быстрым
важн: важным
важност: важность
вал: вал
ввид: ввиду
ведущи: ведущие
век: века, веков
венчает: венчает
взаимодействия: взаимодействия
вид: вид
визит: визит
виктор: виктор
винн: винный
включ: включая
включают: включают
власт: властей
внедрени: внедрению
внешни: внешний
внимани: внимание
внутрен: внутренней
внутренни: внутренние
военн: военной
возведения: возведения
возведён: возведён
воздействия: воздействия
возможност: возможности, возможность
возникал: возникали
возникл: возникла
вокруг: вокруг
вопрос: вопроса
восстает: восстает
восток: востоком
востребованн: востребованным
времен: времен, временем
время: время
все: все
встречаем: встречаемых
втор: второй
вход: входа
выгодн: выгодных
выделяется: выделяется
вымощенны: вымощенные
выполнен: выполнен, выполнена
выполнял: выполняла
выраженн: выраженным
высш: высшего
вытекает: вытекает
выходящи: выходящий
гарантируя: гарантируя
гг: гг
где: где
географиче: географических
гильди: гильдии
главн: главной, главный
глух: глухая
гоголев: гоголевская
год: года, годов, году
голов: голова
гор: горы
горн: горная
город: город, города, городе, городская
городк: городке
городск: городского, городской, городском
горожан: горожан
государств: государства
государствен: государственного
готов: готовой
градообразующи: градообразующие
градостроитель: градостроительного
градостроительны: градостроительные
градостроительств: градостроительства
границ: границ
губернатор: губернатором
губернск: губернского
губернским: губернским
гуманитарн: гуманитарно
давидич: давидич
дальнейш: дальнейшего
данн: данное, данном, данному, данных
дат: дата
дверны: дверные
декор: декор
декоративн: декоративных
декоративност: декоративности
делающ: делающего
демографиче: демографических
ден: день
деревянн: деревянном
дешев: дешевы
деятельност: деятельность
добавлен: добавлено
дом: дом, дома, домов
достоинств: достоинств
друг: других, другой
евгеньевич: евгеньевичем
его: его
единственн: единственным
ерошкин: ерошкина
её: её
жил: жилой, жилых
жител: жителей
жуков: жукова
заведения: заведения
завершения: завершения
задается: задается
заложен: заложена
заложенн: заложенной
занимался: занимался
запад: западом
заране: заранее
застраивалис: застраивались
застройк: застройки
защит: защите
здани: здание, зданий, зданию
здания: здания
значим: значимого, значимых
значимост: значимости
значительну: значительную
значительны: значительные
зодчеств: зодчества
иван: ивана
игр: играя
идентичност: идентичность
иероним: иероним
из: из
известн: известна
известны: известные
изд: изд
изменен: изменены
изменени: изменений
изменения: изменения
изменил: изменили
изначальн: изначально
изучени: изучение
изучения: изучения
изящн: изящная
иль: ильей
имел: имел
именн: именно
имеют: имеют
импери: империи
инвестор: инвесторов
индустриаль: индустриального
инженер: инженером
инновационн: инновационных
институт: института
интеграци: интеграцию
интеллигенци: интеллигенции
интерес: интерес
интересн: интересных
информаци: информацию
инфраструктур: инфраструктуре, инфраструктуры
ипк: ипк
искусств: искусство
использован: использован
использоват: использовать
используются: используются
испытывающ: испытывающих
исследовани: исследование
исследования: исследования
истори: истории, историю
историче: исторических
историческ: исторического, историческом
исторически: исторические
история: история
источник: источников
как: как
каменн: каменное, каменный, каменными
каменны: каменные
камня: камня
канон: канонов
караванн: караванная
карниз: карниз, карнизы
киникеев: киникеева
кириллович: кирилловича
кирилов: кирилова
кириченк: кириченко
кирпич: кирпича, кирпичного
кирпичн: кирпичном, кирпичный
китнер: китнер
кладк: кладкой
классическ: классическом
климат: климата
ключев: ключевой
ключеву: ключевую
ключевы: ключевые
кн: кн
ко: ко
комбинаци: комбинацию
коммерче: коммерческих
коммерчески: коммерческие
композици: композиции
композиция: композиция
контекст: контекста
конц: конца, конце, концом
концепция: концепция
коровин: коровин
котор: которая, которое, который
которы: которые
краеведче: краеведческий
крайн: крайне
крепост: крепости, крепость
крепостн: крепостной
кром: кроме
кругл: круглым
крыл: крыле
крыш: крышей, крышу
кузнечн: кузнечной
культур: культурного
культурн: культурное, культурных
культурны: культурные
купече: купеческих
купечески: купеческие
купеческу: купеческую
купц: купцов, купцом
лавк: лавки
лазаретн: лазаретная
ландшафт: ландшафт
лев: левом
литвак: литвака
литератур: литературы
льв: льва
магазин: магазин, магазина, магазине
магистрант: магистрант
мальчик: мальчиков
мариин: мариинская
материал: материала
мац: маца, мацем
межд: между
международн: международной
мелк: мелкой
менодвор: менодворская
менял: меняли
мест: месте, местного, место
местн: местных
метод: методы
множеств: множества
модерн: модерн, модерна
модернизаци: модернизации
модернистск: модернистском
мокр: мокрая
мордов: мордовский
мощ: мощи
мужск: мужского
муз: музей
набережн: набережная
наблюдения: наблюдения
над: над
названия: названия
наличник: наличники
направлениях: направлениях
направлялся: направлялся
населения: населения
наследи: наследие
настояще: настоящее
натураль: натурального
науч: научного
находился: находился
начал: начала, начале, начало, началом
началь: начального
немал: немало
необъятн: необъятной
необычн: необычной
неорусск: неорусском
нов: новое, новым, новых
новизн: новизну
новы: новые
ног: ногу
норм: нормы
нужд: нужд
нуждалос: нуждалось
нын: ныне
обеспечивал: обеспечивало
обилия: обилия
област: области
облик: облик
обновления: обновления
оборонительн: оборонительных
оборудован: оборудовано
образ: образом
образовательн: образовательный
обращения: обращения
обув: обуви
общероссийским: общероссийским
обществ: общество
общественн: общественно, общественной
объект: объектов
объективн: объективных
ограничиваяс: ограничиваясь
одежд: одежды
одн: одна, одной
однак: однако
одним: одним
одновременн: одновременно
одноэтажн: одноэтажное, одноэтажный
одобрени: одобрение
ознаменовал: ознаменовало
ой: ой
окн: окнами, окном
оконны: оконные
окружения: окружения
окунуться: окунуться
он: он
они: они
описания: описания
описательн: описательный
организаци: организации
оренбург: оренбург, оренбургом
оренбургск: оренбургского, оренбургской
ориентируется: ориентируется
орск: орск, орска, орская, орске, орских, орского, орской, орску
орски: орский
орским: орским
осев: осевой
основан: основан
основн: основная, основное, основной
особ: особо, особый
особенн: особенно
особенност: особенностей, особенности
особняк: особняк
осознат: осознать
остался: остался
останавливаяс: останавливаясь
от: от
отдалённ: отдалённом
отделени: отделению
отделк: отделки
открывает: открывает
отличаются: отличаются
отметим: отметим
отраж: отражая
отсутстви: отсутствием
отсутствуют: отсутствуют
отчетлив: отчетливо
официальн: официальное
оформлен: оформлен
оформлени: оформлении
оценк: оценка
очен: очень
оштукатуренн: оштукатуренных
паллас: палласа
перв: первого
переживал: переживал
перемен: перемены
переход: переход
переходя: переходя
период: период, периодов
перифери: периферии
петр: петра
пионерск: пионерской
пионерску: пионерскую
план: плана, плане, планы
планирования: планирования
планировочн: планировочной
племянник: племянники
поверхност: поверхностей
погреб: погреб
под: под
подвал: подвалами, подвале
подлежал: подлежал
подписывалис: подписывались
подражательност: подражательности
подход: подходов
подчеркивает: подчеркивает
позволяет: позволяет
позж: позже
покрыт: покрытым
полноценн: полноценный
положени: положении
полуколонк: полуколонками
помещения: помещения
помогл: помогли
понимани: понимании
попечител: попечителем
популярн: популярным
портал: портал, порталом
поселения: поселения
посл: после
последн: последнего
поставлен: поставлено
постепенн: постепенно
построек: построек
построил: построил
постройк: постройка, постройки
постройках: постройках
появилис: появились
правления: правления
практичн: практичным
превращени: превращению
предваритель: предварительного
предоставляет: предоставляет
предоставляя: предоставляя
предпосылк: предпосылки
предприимчив: предприимчивым
предприятия: предприятия
представител: представителей, представители
представляет: представляет
преемственност: преемственность
прежним: прежним
преимущественн: преимущественно
преобразовывалас: преобразовывалась
при: при
приверженность: приверженностью
привлек: привлекая
пригород: пригороды
приказчик: приказчиков
применения: применения
пример: пример, примере, примером
приобрет: приобретая
приподнят: приподнятой
причин: причин
проблемн: проблемный
провинциальн: провинциальном
прогресс: прогресса
продаж: продажей
проект: проект, проекты
проектировани: проектировании
проектируем: проектируемого
проем: проемы
производственны: производственные
промышленн: промышленная, промышленной
промышленны: промышленные
проследит: проследить
прослеживается: прослеживается
против: против
протокол: протокола
процветания: процветания
процесс: процесс, процессов
прошл: прошлого, прошлым
пут: путь
работ: работы
развив: развивая
развивался: развивался
развити: развитие, развитию
развития: развития
разин: разина
различн: различных
различны: различные
разн: разных
разнообразия: разнообразия
разнообразны: разнообразные
разрабатывал: разрабатывали
разрез: разрезе
район: района
ране: ранее
располагалис: располагались
расположен: расположена
расположени: расположении
расположенн: расположенное, расположенный
расположилос: расположилось
распространен: распространена
рассмотрени: рассмотрение
расстекловк: расстекловкой
расширени: расширении
расширил: расширило
реакция: реакция
реализация: реализация
регион: региона
регионах: регионах
регламент: регламентам
редки: редкие
резк: резко
результат: результате
рельефны: рельефные
ремонт: ремонта
ресурс: ресурс
ретроспективн: ретроспективный
решени: решении, решений
рол: роль
российск: российской
рост: рост, ростом
рубеж: рубежей
руководств: руководством
рус: русская
рф: рф
сайт: сайт
сам: сама, самой, самых
самостоятельн: самостоятельным
сара: сараи
свидетельствовал: свидетельствовало
сво: свою
связ: связей, связи
связанны: связанные
себ: себе
сей: сей
сем: семей
сергеевн: сергеевна
символ: символа
симон: симона
систем: системе, системы
склад: склады
скоплени: скопление
скоре: скорее
слобод: слободе
слободк: слободке, слободки
слов: слова
сложн: сложной
сложност: сложности
служил: служил
случа: случаев
смирнов: смирнова, смирновым
со: со
соб: собой
соблюдения: соблюдения
событи: событие
совершенн: совершенно
советск: советского, советской
современн: современны
современност: современность
согласования: согласования
содержал: содержал
создав: создавая
создавал: создавали
создавалис: создавались
создал: создали
солодов: солодова
сообществ: сообщества
сооружалис: сооружались
сооружения: сооружения
соответстви: соответствие
соответствуют: соответствуют
соперничат: соперничать
сопутствующ: сопутствующих
сосредоточилис: сосредоточились
составлени: составлением
состояни: состояние
социаль: социального
социальн: социально
сочетает: сочетает
специальн: специально
список: список
способн: способный
способствовал: способствовала, способствовало
справочник: справочник
спроектирован: спроектировано
сравнени: сравнению
сравнительн: сравнительно
срез: срез
стал: стал, стало
стандарт: стандартам
становится: становится
становлени: становлению
стар: старой
стать: статьи
стекл: стеклами
степан: степана
стил: стиле, стилей, стилем, стили, стиль
стилистик: стилистика
стиля: стиля
стилям: стилям
стилях: стилях
стимулирующ: стимулирующих
сторон: стороны
стратегиче: стратегическая, стратегический
строги: строгие
строени: строение
строитель: строительного
строительн: строительному
строительств: строительстве, строительство
структур: структуры
сыграл: сыграли
тайн: тайн
так: таких, таком
таки: такие
таким: таким
татьян: татьяна
ташкентск: ташкентской
творц: творцы
творческ: творческого
текст: текст
текстиля: текстиля
телеграфн: телеграфная
тенденциям: тенденциям
территори: территории
технологическ: технологического
течени: течение
тог: того
толст: толстого
тольк: только
том: том
торгов: торгово
торговл: торговли
торговы: торговые
точках: точках
традиционн: традиционных
трансформаци: трансформации, трансформацию
трансформировалас: трансформировалась
требовал: требовали
требованиям: требованиям
требующи: требующие
три: три
туркестан: туркестанская
угл: углу
углов: угловой
удалос: удалось
уделялос: уделялось
удобн: удобны
уезд: уезд, уездного
уездн: уездном, уездный
укреплени: укреплении
укреплял: укреплял
улиц: улиц, улица, улице, улицу, улицы
университет: университета
уникальн: уникальный
уникальну: уникальную
урал: урал, урала
ураль: уральское
усадьб: усадьбы
услови: условий
условия: условия
условиях: условиях
установленн: установленным
устойчив: устойчивому
утвердит: утвердить
утверждени: утверждению
учеб: учебного
училищ: училища
уютн: уютный
фасад: фасад, фасада, фасадам, фасадами, фасаде
фигурн: фигурной
физиче: физический
филиал: филиала
форм: форм, форма, формы
форштадт: форштадте
фридрихович: фридриховичем
фронтон: фронтоном
фронтонн: фронтонная
функциональн: функциональной
характеризующийся: характеризующийся
характерн: характерном
хот: хоть
хранивши: хранивший
хронологическ: хронологическо
художественн: художественных
цветн: цветными
цель: целью
центр: центр, центра, центре, центром
центральн: центрально
част: часто, частого
частичн: частично
челябинск: челябинск
черкас: черкас
черт: черты
четырехкласс: четырехклассного
четырёх: четырёх
числ: числе
чист: чисто
что: что
шаг: шаг
швец: швецов
швецов: швецова
шевченк: шевченко
шевченков: шевченкова
шел: шел
шло: шло
шрётер: шрётер
штат: штате
штукатурк: штукатуркой
штукатурн: штукатурными
шустов: шустова
эволюци: эволюции, эволюцию
эклектик: эклектика
эклектичн: эклектичном
экономик: экономики
экономиче: экономических, экономическое
экономическ: экономического, экономической
экономически: экономические
экономическу: экономическую
экспедиц: экспедицией
эксперимент: эксперимента
эксплуатаци: эксплуатации
электронн: электронный
элемент: элементов, элементы
энциклопедия: энциклопедия
этап: этапы
эти: эти
этим: этим
этих: этих
это: это
этом: этом
этот: этот
южн: южно, южного, южный, южных
юрасов: юрасова
является: является
являющееся: являющееся
ярки: яркий
