автореферат: автореферат
адаптироваться: адаптироваться
акимович: акимовна
активный: активное
акушерский: акушерском, акушерскую
александрович: александровна
ален: алена
андрюшин: андрюшина
анжелика: анжелика
апрель: апреля
армия: армии, армия
база: базе, базу, базы
без: без
безграничный: безграничного
бельё: белья
благодарный: благодарным
благодаря: благодаря
боевой: боевой, боевых
бой: боя
более: более
больница: больниц, больницах, больнице, больницы
больной: больными
больший: большую
большой: большое
брать: брали
бремя: бремя
бузулук: бузулук, бузулуке
бузулукский: бузулукская, бузулукском
бывший: бывшего
быть: был, была, были, было
важный: важен
великий: великая, великой, великую
вернуться: вернулась
вести: вести
весь: всей, всем, всех, вся
ветеран: ветеран
вклад: вклад
включая: включая
владимир: владимир
влксм: влксм
вложить: вложили
вместе: вместе
внедряться: внедрялись
внести: внес, внесены, внесли, внёс
внимание: внимание
военный: военно, военного, военное, военные, военным, военных
возвращаться: возвращались
возвращение: возвращения
возникнуть: возникла
война: войн, война, войне, войны
вооружённый: вооруженными, вооруженных
восстановление: восстановление
враг: врагом
врач: врачей, врачом
время: времени, время
всегда: всегда
вселять: вселяли
второй: вторая, второй
выезжать: выезжая
выносить: выносили
выполнять: выполняли
выхаживать: выхаживали
где: где
германия: германией
гигиена: гигиене
гинекологический: гинекологическую
главный: главным
глаз: глаза
глазной: глазного, глазном
го: го
год: год, года, годов, году, годы, лет
город: города, городе
городской: городской
госпитализация: госпитализация
госпиталь: госпитале, госпиталей, госпитали, госпиталях
госпитальный: госпитальной, госпитальную
государственный: государственного
готовый: готов, готовы, готовые
группа: группах, группы
далеко: далеко
дальнейший: дальнейшего
данные: данным
два: двух
двенадцать: двенадцатью
девушка: девушка
девчонка: девчонку
дегтярёв: дегтярева
действие: действий
действовать: действовало
декабрь: декабря
дело: делу
демобилизация: демобилизации
день: день, дни
деятельность: деятельность
диагностика: диагностики
директор: директор
дис: дис
дисциплина: дисциплинам
длительность: длительность
до: до
добиться: добилась
доктор: доктор
документ: документы
домохозяйка: домохозяек
дорога: дорогами
доц: доц
другой: другие, других, другого
дух: дух
душаева: душаева
единственный: единственного
екатерина: екатерина
есть: есть
женщина: женщинам, женщины
жизнь: жизней, жизни, жизнью
заболевание: заболеваний, заболеваниям
заболеть: заболевших
задача: задачей
закончить: закончить
заниматься: занимались
запад: западе
запомниться: запомнились
заслуживать: заслуживает
заслужить: заслуженным
захватить: захвачена
звезда: звезды
здравоохранение: здравоохранения
земля: земле
зимний: зимние
знамя: знамени
значение: значение
значительный: значительным
зона: зоне, зоны
из: из
изд: изд
изменение: изменения
изоляция: изоляция
иметь: имеющим
инвалид: инвалид
институт: институт, институте
инструктор: инструкторов
инфекционный: инфекционный, инфекционным, инфекционных
ипк: ипк
история: истории
истый: ист
исчезнуть: исчезли
итог: итоге
кадр: кадры
каждый: каждом, каждый
казахстан: казахстане
как: как
канд: канд
каникулы: каникулы
канюк: канюков
категория: категории
кафедра: кафедра, кафедры
квалификация: квалификации
квалифицировать: квалифицированных
клинический: клинической
ключевой: ключевые
кн: кн
койка: коек
конфликт: конфликта, конфликтами
который: которое
красный: красного, красной, красный
крест: крест
кровопролитный: кровопролитным
крымский: крымском
кто: кто
кукушкин: кукушкина
курс: курса, курсы
кызыл: кызыл
лекарство: лекарств
летний: летние, летнюю
лечебный: лечебный
лечение: лечение, лечения
лечить: лечили
литература: литературы
лишение: лишениям
лишь: лишь
людская: людские
максимович: максимовна
мария: мария
материал: материалов, материалы
материальный: материальных
медаль: медали, медалями
медик: медики
медицинский: медицинская, медицинские, медицинский, медицинским, медицинских, медицинского, медицинской, медицинском
медсестра: медсестер, медсестры
местный: местных
месяц: месяца
методика: методики
микрохирургия: микрохирургия
миллиард: миллиардов
миллион: миллионов
минздрав: минздрава
мирно: мирно
мировой: мировая
многие: многие
многочисленный: многочисленными
множество: множество
мнтк: мнтк
мой: мои
молодёжный: молодёжной
мужественно: мужественно
мы: нам
наградить: награждена
над: над
надежда: надежду
население: населения
настаивать: настаивала
настроение: настроение
насчитываться: насчитывалось
наука: наук
научный: научный
начало: начала, начале
наш: наше
невероятно: невероятно
неделя: недели, недель
недостаточный: недостаточной
ненормированный: ненормированным
неоценимый: неоценимый
непростой: непростым
несколько: несколько
нести: несли
нехватка: нехваткой
николаевич: николаевна
новый: новейшие, новым
нуждаться: нуждался
о: об
обеспечить: обеспечена
областной: областного, областной
область: области, область
оборона: обороне
оборонительный: оборонительных
оборудование: оборудование, оборудовании
обучение: обучение, обучения
обучить: обучены
общественный: общественных
общий: общий
огромный: огромный
один: одного, одной
однако: однако
оказание: оказании, оказанию, оказания
оказаться: оказались
оказывать: оказывали, оказывало, оказывая
около: около
окончить: окончив
окулист: окулистов
она: ее, ей, ней, она
они: им, ими, их, ними, них, они
оперативный: оперативные
операция: операции, операций
оперировать: оперировать, оперируя
орда: орде
орден: ордена, орденом
оренбург: оренбург, оренбурга, оренбурге
оренбургский: оренбургская, оренбургского, оренбургской
оренбуржец: оренбуржцев
оренбуржье: оренбуржье
освобождение: освобождении
осень: осени
основной: основной
основный: основное
особенно: особенно
особый: особое
остальной: остальные
острый: острая
от: от
отделение: отделении, отделения
отечественный: отечественная, отечественной
отечество: отечества
открываться: открываться
отправиться: отправилась
отработать: отработала
отражать: отражавшие
отряд: отрядах
оцениваться: оценивалась
очерковый: очерков
память: память
партизанский: партизанских
пациент: пациентов
пекло: пекле
первый: первую, первые
перевозка: перевозкой
передовой: передовой
перерыв: перерыва
пересмотреть: пересмотрены
период: период, периоды
периодически: периодически
персонал: персонала
победа: победу, победы
повседневный: повседневной
погибнуть: погибли
под: под
подарок: подарки
подвергать: подвергая
подвиг: подвиг, подвиге
подвижный: подвижных
подготовить: подготовила, подготовлено
подготовка: подготовки
поддерживать: поддерживали
поддержка: поддержку
поднимать: поднимали
подразделение: подразделении
поколение: поколение, поколением
поле: поле, поля
полевой: полевых
политика: политики
полмиллиона: полмиллиона
полный: полным
половина: половина, половину
помещение: помещений
помогать: помогали, помогая
помощь: помощи, помощь
порой: порой
порядок: порядка
после: после
пострадать: пострадали
поступить: поступила
потапов: потапова
потеря: потерям
потомок: потомкам
потребность: потребность
почти: почти
пошив: пошиве
поэтому: поэтому
появиться: появились
преданность: преданность
предприятие: предприятий
предупреждение: предупреждение, предупреждении
привести: привело
призвать: призвана
признание: признание, признания
прийтись: пришлось
принимать: принимала
принять: принял
приходиться: приходилось
проведение: проведении
проводить: проводили
проводиться: проводились, проводилось
программа: программе, программу, программы
проделать: проделанная
продолжать: продолжала
продолжить: продолжила
пройти: прошли
промышленный: промышленных
противовоздушный: противовоздушных
профессионализм: профессионализм, профессионализму
процедура: процедуры
работа: работа, работах, работы
работать: работала, работали, работать, работая
работник: работники, работников
рабочий: рабочий, рабочими
ради: ради
развернуть: развернуто
развитие: развития
различный: различных
разный: разных
разработка: разработке
район: районе
раненый: раненым, ранеными, раненых
ранить: раненным
распоряжение: распоряжению
распространение: распространения
рассказ: рассказов
ратный: ратный
реабилитация: реабилитацию
ребёнок: детей
регион: регион
ремонт: ремонте
ресурс: ресурсов
решение: решению
рисковать: рискуя
родный: родной
родственник: родственники
рсфср: рсфср
рубль: рублей
руководитель: руководителем, руководитель
руководство: руководством
рф: рф
рядовой: рядовые
с: со
сайгин: сайгин
сам: самого, самом
самоотверженно: самоотверженно
самоотверженность: самоотверженности
самый: самым
санитар: санитаров
санитарка: санитаркой
санитарный: санитарной, санитарных
сборник: сборник
сведение: сведениям
своевременный: своевременная
свой: своего, своей, своем, своему, свой
свыше: свыше
священный: священную
себя: себя
семья: семьей, семьями
сержант: сержанты
сестра: сестер, сестра, сестрой, сестры
сила: сил
симферополь: симферополе
сконцентрировать: сконцентрирована
следовать: следует
слово: слова
сложный: сложные, сложный
служить: служила
совершать: совершал
советский: советский, советского
современный: современные
согласно: согласно
создание: создании
создать: созданы
сократить: сокращены
сократиться: сократилась, сократился
солдат: солдат, солдатам
составлять: составлявших, составляет, составляли
сострадание: состраданию
сотня: сотен
сотрудник: сотрудники
сохранять: сохранять
союз: союза
спасать: спасали, спасать
спасение: спасение, спасения
специализировать: специализированные
специалист: специалистах, специалистов
список: список
сражаться: сражались
сражение: сражений
среди: среди
средний: средних
ссср: ссср
стаж: стаж
стать: стала, стали
степанович: степановна
степень: степени
столкновение: столкновений, столкновения
столкнуться: столкнулись
страна: стран, страны
стрик: стрике
строй: строй
студент: студент
суровый: суровым
сутки: сутками
тактика: тактике
территория: территории, территория
техника: техники
течение: течение
типография: типография
только: только
тот: тех, того, том
трудиться: трудились
трудность: трудностям
трудный: трудным
трудовой: трудового, трудовой
трудящийся: трудящиеся, трудящихся
тыл: тылу
тыловой: тыловой, тыловых
тысяча: тысяч
тысячелетие: тысячелетия
тяжёлый: тяжелых
убитый: убитых
уважение: уважения
увеличиться: увеличился
угроза: угрозой
уделяться: уделялось
удостоить: удостоена
уезд: уезде
уйти: уйти, ушла
украинский: украинского
умножать: умножая
унести: унесшими
университет: университета
уник: уник
урал: урал, урала, урале
уровень: уровнях
условие: условиям, условиях
утешение: утешение
ухаживать: ухаживали
уход: уходу
участвовать: участвовали
участие: участие, участии
учебный: учебный
ученик: учеников
учиться: училась
учреждение: учреждения, учреждениях
факультет: факультет
фельдшерский: фельдшерском
фельдшерско: фельдшерско
филиал: филиала
фронт: фронт, фронта, фронтах, фронту
функционирование: функционировании
хвостов: хвостова
хирург: хирургом
хирургический: хирургической
хирургия: хирургии
хотеть: хотела
цель: целью
цк: цк
часто: часто
человек: людей, люди, людях, человек
человеческий: человеческих
человечество: человечеству
челябинск: челябинск
четыре: четырёх
число: числе, число
чкалов: чкалове
чкаловский: чкаловская, чкаловский, чкаловской
что: что
школа: школу
эвакогоспиталь: эвакогоспитале, эвакогоспитали, эвакогоспиталя
эвакуация: эвакуацией, эвакуации
экстренный: экстренную
энциклопедический: энциклопедический
эпидемиологический: эпидемиологических
эпидемический: эпидемических
эсфирь: эсфирь
это: этого
этот: эта, эти, этих, этой, этот
юж: юж
южный: южного, южном, южный
являться: является
