eженедельник: eженедельник
абдалла: абдалла, абдаллой
адель: адель
активный: активнее
александрович: александрович
али: али
аль: аль
альтернативный: альтернативного
американский: американским, американскими
анализ: анализе
анархический: анархической
аннотация: аннотация
антимонархический: антимонархической
апрель: апреле
араб: арабов
арабский: арабская, арабских, арабской, арабском
аравия: аравией, аравии, аравию, аравия
аргумент: аргументы
ахмет: ахмет
ахра: ахрам
багдад: багдаде
баланс: баланс, баланса
барзегар: барзегар
бахрейн: бахрейна, бахрейне
безопасность: безопасности, безопасность, безопасностью
беспорядок: беспорядков
бинарный: бинарный
ближневосточный: ближневосточная, ближневосточной, ближневосточными
ближний: ближнего, ближнем, ближний
более: более
больший: большей
большинство: большинства
большой: больше, большое
бороться: борются
борьба: борьба, борьбе, борьбу
быстрый: быстрой
быть: будучи, будь, была, были, было, быть
важно: важно
важный: важна, важной, важный, важным, важных
вашингтон: вашингтона
велеть: велел
верховный: верховного
весна: весна, весны
весь: весь
вещь: вещи
взаимный: взаимное, взаимным
взаимоотношение: взаимоотношений
виталиевич: витальевна
владикавказ: владикавказ
власть: власти, власть
влияние: влияние, влиянием, влияния
влиятельный: влиятельных
влиять: влияя
вложить: вложила
внешнеполитический: внешнеполитическими, внешнеполитического, внешнеполитическом
внешний: внешней, внешний, внешним, внешняя
внимание: внимание
внутренний: внутренний, внутренних
внутрирегиональный: внутрирегиональными
военный: военной, военным, военными
воздействие: воздействия
воздерживаться: воздерживаются
возможно: возможно
возможность: возможность
война: войн, война, войнам, войны
вооружённый: вооруженных
вопрос: вопрос, вопроса, вопросах
восток: восток, востока, востоке
впервые: впервые
враждебность: враждебности
время: времен, время
всеобщий: всеобщей
всерьёз: всерьез
вспышка: вспышка
встреча: встрече, встречи
всё: все
вторжение: вторжение
второй: вторая, второй
второстепенный: второстепенным
вы: вам
вызвать: вызванная
выиграть: выиграл
выигрыш: выигрыш
выйти: вышла
вынудить: вынуждены
вынуждать: вынуждает
выполнять: выполняла
высокопоставленный: высокопоставленные, высокопоставленным, высокопоставленными
вытекать: вытекающий
гауз: гауз
где: где
гегемонистский: гегемонистским
генерал: генералом
геополитика: геополитике, геополитики
геополитический: геополитическом
герц: герцем
главный: главным, главными, главных
глубина: глубину
год: года, году
голова: голову
государственный: государственное, государственный
государство: государства, государствами, государство
готовиться: готовиться
готовый: готового
гражданский: гражданских, гражданской
давать: дает
давутогла: давутоглу
два: два, двумя, двух
действие: действия
действительно: действительно
действовать: действующего, действующие, действующим, действующими, действующих
делать: делает, делать
дело: дело
демократический: демократическая
демонстрация: демонстрациями
держава: держав
дж: дж
джон: джоном
джубейра: джубейр
дилемма: дилемма, дилеммы
динамичный: динамичным
династический: династических
дипломатический: дипломатических
директор: директор
дисциплина: дисциплине
до: до
добавить: добавив, добавить
документ: документах, документу
документальный: документальных
долгий: долгое
должный: должен
доминирование: доминирования
доминировать: доминировать, доминируют, доминирующего
дополнение: дополнение
достижение: достижение
доц: доц
драматический: драматические
друг: друг, другом
другой: другая, другими, других, другого, другой, другому
духовный: духовной, духовным
дэвид: дэвидом
египет: египет, египте
единственный: единственная, единственной
есть: есть
желаемый: желаемой, желаемым
заключаться: заключались
залив: залива
заметный: заметными
защита: защиту
здесь: здесь
змея: змее
значимость: значимости
значительный: значительные, значительным
игра: игру
играть: играет, играть
игрок: игрока, игрокам, игроками, игроком
идентичность: идентичности, идентичность
идеологический: идеологическая, идеологические, идеологических
из: из
избежать: избежать
известный: известная
изменить: изменили, изменить
измерение: измерение
изолировать: изолировать
именно: именно
иметь: имеет
инструмент: инструмента
интенсивность: интенсивность
интерес: интересами
интерпретация: интерпретация
иордания: иордания
ирак: ирак, ираке
иракский: иракская, иракской
иран: иран, ирана, иране, ираном, ирану
ирано: ирано
иранский: иранская, иранским
ирина: ирина
исключительно: исключительно
ислам: ислама
исламский: исламская, исламской
использовать: используемого
исследование: исследований
истеблишмент: истеблишментом
история: истории
источник: источник, источников
истый: ист
итог: итог
йемен: йемене
к: ко
каждый: каждого, каждое
как: как
какой: какие
каледония: каледония
канд: канд
карта: карта
касаться: касается
катализатор: катализатор
кафедра: кафедра
квази: квази
кирилл: кирилл
ключевой: ключевые, ключевых
когда: когда
командующий: командующим
компонент: компонент
конец: конец
конечный: конечном, конечным
конкуренция: конкуренции, конкуренция
конкурировать: конкурируют
консервативный: консервативным
консультативный: консультативного
конфликт: конфликтов
концепция: концепция
король: королем, король, короля
который: которая, которого, которое, которой, котором, которую, которые, который
крайний: крайней
кризис: кризисах
крокер: крокером
кроме: кроме
курс: курс, курсе
ландшафт: ландшафте
легитимность: легитимность
лежать: лежат
ливана: ливан, ливане
лидер: лидера
лидерство: лидерство
литература: литературы
лицо: лиц, лица, лицами, лицом
лохов: лохова
любой: любая, любого
лёгкий: легче
магистрант: магистрант
максимально: максимально
мартынов: мартынов
материальный: материальные, материальным
между: между
международный: международная, международной, международные, международных
межконфессиональный: межконфессионального
менее: менее
меньшинство: меньшинства
мера: мере
место: мест
метафизика: метафизика, метафизику
механизм: механизм, механизмом
мир: мир, мире
мирный: мирные
мировоззрение: мировоззрении, мировоззрений, мировоззрения
миссия: миссию
миф: мифы
мнение: мнении, мнению
многий: многими, многих
множество: множество
мобилизовывать: мобилизовывать
модернизация: модернизации, модернизацию
можно: можно
монархия: монархия
моргентау: моргентау
мочь: мог, могут, может
мусульманский: мусульманский
называть: называемых, называет
наиболее: наиболее
накопление: накопления
нанести: нанести
нападение: нападений
напасть: напасть
напомнить: напомнил
направлять: направлять
например: например
наравне: наравне
настоящий: настоящее
наука: наук
научный: научный
находиться: находится
нация: нациями
начало: начала, начало
неарабский: неарабской
небольшой: небольшими, небольшой
негосударственный: негосударственное
недавний: недавних
недоверие: недоверием
незащищённый: незащищенными
неизбежно: неизбежно
некоторый: некоторые
нематериальный: нематериальные
несколько: несколькими
несмотря: несмотря
несуннитский: несуннитской
нет: нет
ничего: ничего
новый: новом, новым
ноябрь: ноября
нулевой: нулевой
нынешний: нынешней
оба: оба, обе, обеим
обеспокоить: обеспокоены
обозначать: обозначает
образ: образом
образование: образование
образовать: образует, образуют
обратиться: обратились
обсуждение: обсуждением
общепризнать: общепризнано
общественный: общественном
один: один, одним, одно, одного, одному
однако: однако
означать: означает, означающие
омайма: омайма
он: его, он
она: ее, она
они: им, их, них, они
операция: операциям
опираться: опирается
опосредовать: опосредованным
оправдать: оправдать
оправдывать: оправдывала
определять: определяющей
определённый: определенную
опустошение: опустошение
оружие: оружия
осетинский: осетинский
основа: основе, основу
основание: основаниях
основный: основными, основных
основываться: основывается
особенно: особенно
особый: особый
острый: острую
от: от
открытый: открытой
отметить: отметить
отношение: отношение, отношении, отношению, отношения, отношениях
отрубить: отрубить
официальный: официальные
очевидность: очевидность
очевидный: очевидной
очередь: очередь
ощутимый: ощутимой
палестина: палестина, палестине
палестинец: палестинцев
палестинский: палестинское
первый: первый
переменный: переменной
персидский: персидского, персидской
петреус: петреусом
план: планам
плохой: худшему
подводить: подводя
поддерживать: поддерживали
поддержка: поддержки, поддержку
подкрепить: подкрепленный
подсистема: подсистема
подчинение: подчинения
подчёркивать: подчеркивает
позиция: позиций
политика: политика, политике, политики
политически: политически
политический: политическая, политическим, политическими
положение: положение
положить: положить
помимо: помимо
помощь: помощью
популистский: популистской
пора: пор
поскольку: поскольку
последний: последними
последовать: последовавшие
последствие: последствия
посол: послом, посол
посольство: посольства
потрясение: потрясений
похоже: похоже
правда: правда
правило: правило
правительство: правительства, правительство
правящий: правящая
практика: практике
превратиться: превратился
превращение: превращение
предполагать: предполагает
предпочтение: предпочтениями
представить: представлена, представлены
представление: представление
представлять: представляет
представляться: представляется
предыдущий: предыдущим, предыдущих
преобладать: преобладающем
преобразование: преобразования
преследовать: преследует
при: при
привести: привели
привилегия: привилегиях
привлечь: привлек
приводить: приводила
придавать: придавать, придают
призма: призму
признать: признает
призыв: призывах
призывать: призывает
пример: примерами, примером
примечательный: примечательных
принять: приняла
приобрести: приобрела
приобретать: приобретать
приоритет: приоритетом
притяжение: притяжения
приход: приходом
причина: причинам, причины
проблема: проблему
программа: программа, программе, программу, программы
продолжаться: продолжается
проиграть: проиграть
проигрыш: проигрышу
происходить: происходит
просочиться: просочившихся
против: против
противостояние: противостояние
процветание: процветание
процесс: процессом
прочее: прочего
проявление: проявлений
проявлять: проявляют
равный: равен
развитие: развитие, развитию
разделение: разделение
различный: различные
размах: размах
разногласие: разногласия
разрушение: разрушениям
райан: райаном
рамка: рамки
раскол: раскола
распасться: распался
распространение: распространение, распространению, распространения
рассматривать: рассматривает, рассматривать
расширять: расширять
реализация: реализации
реальность: реальность
революция: революции, революций
регион: регионе
региональный: региональная, региональное, региональной, региональном, региональный
результат: результатом
религиозно: религиозно
религиозный: религиозной, религиозные
религия: религия
республика: республика
ресурс: ресурсы
решение: решение, решения
род: рода
роль: роли, роль
ромбовидный: ромбовидный
руководитель: руководитель
рф: рф
с: со
салафизм: салафизм
салафитский: салафитская
самоидентификация: самоидентификации, самоидентификация
самый: самый, самым, самых
саудовский: саудовская, саудовское, саудовской, саудовскую
свобода: свобода
свой: свое, своего, своей, своем, своими, своих, свою
связанный: связанного
связь: связи
святой: святых
себя: себя, собой
северо: северо
сей: сих
сектантский: сектантская, сектантский, сектантских, сектантской
сила: сил, силы
сирия: сирии, сирия
ситуация: ситуации, ситуация
сказать: сказал, сказать
склонный: склонно
следовать: следует
следствие: следствие, следствием
слово: слова
сложиться: сложившейся
случай: случаях
смена: смене
сми: сми
смысл: смысле
событие: событий, события, событиями
согласно: согласно
соединить: соединенным
создание: создание, создания
сознательный: сознательное
сообщаться: сообщается
соответственно: соответственно
соответствие: соответствии
соперник: соперник, соперников
соперничество: соперничества, соперничестве, соперничество, соперничеству
составлять: составляющим
сотрудничать: сотрудничает
сотрудничество: сотрудничество
союз: союзов
союзник: союзников
специфичный: специфичным
список: список
среда: среде
среди: среди
срединный: срединный
средний: средний
средство: средства
стадия: стадии
стамбул: стамбул
стать: стала, стали, стать
сторона: сторон, сторонам, стороны
страна: странами, стране, страной, страны
стратегический: стратегическим, стратегических, стратегического
стратегия: стратегия
стремиться: стремилось, стремится, стремятся
стремление: стремлении
субъект: субъекта, субъектам, субъектами, субъекты
сугубо: сугубо
сумма: суммой
суннит: суннитами, суннитов
суннитский: суннитской
суть: сути
существование: существованию
существовать: существовать, существует, существуют
существующий: существующую
сфера: сферу
сформулировать: сформулирована
счёт: счете
сша: сша
тайный: тайным
такой: такие, таким, такого
тегеран: тегераном
телеграмма: телеграммы
тем: тем
теория: теории
тесно: тесно
тесный: тесных
тип: тип, типа
тогдашний: тогдашним
только: только
тот: того
третий: третье, третьими
треугольник: треугольник, треугольника
треугольный: треугольном
три: три
тупиковый: тупиковая
турция: турция
тюркский: тюркские
увеличить: увеличили
увидеть: увидеть
угроза: угрозами, угрозой
удар: удар
улус: улусы
университет: университет
уничтожение: уничтожения
упорный: упорными
упрочить: упрочить
усиление: усиление
усилие: усилия
усилить: усилить
условие: условия, условиям
усугублять: усугубляющих
утверждать: утверждает, утверждал
участник: участник, участника, участникам, участниками, участники
файяд: файяд, файяда
фактор: фактор, факторов
физика: физика
философия: философия
форма: форма, форме, формы
формировать: формируя
функция: функцию
ханс: ханса
характер: характер
хезболла: хезболлой
хетагуров: хетагурова
ход: ход
хороший: хорошим
хотя: хотя
хранение: хранении
целое: целом
цель: цели, целями
центр: центр, центра, центре, центров
центральный: центрального
цикл: цикл
цитата: цитата
частность: частности
частый: частых
чей: чья
через: через
четырёхугольник: четырехугольник
что: что
чувствительность: чувствительность
чужой: чужой
шиизм: шиизм
шиит: шиитами, шииты
шиитский: шиитская, шиитский, шиитского, шиитской
широкий: широкой
штат: штатам
элита: элиты
это: этим, это, этом
этот: эта, этих, этой, эту
явление: явлением
являться: является, являются
ядерный: ядерная, ядерного, ядерной
