авиация: авиацией, авиации
автотранспорт: автотранспорта
агрессор: агрессора
активно: активно
активный: активную
альтернативный: альтернативную
аннотация: аннотация
апрель: апреля
армия: армии, армий, армию, армия
архангельск: архангельск
ассигнование: ассигнования
астрахань: астрахань
атаковать: атакующего
барбаросс: барбаросса
барьер: барьер
белоруссия: белоруссии
бессарабия: бессарабии
битва: битва
блокада: блокада
боевой: боевой, боевых
большевистский: большевистская
большой: большой, велики
борьба: борьба, борьбы
брест: брест
бронетанковый: бронетанковыми, бронетанковых
будяков: будякова
быстро: быстро
быть: будет, был, была, были
важный: важным
введение: введением
вводиться: вводилась, вводился
ведение: ведении
век: века
великий: великая, великой
вермахт: вермахт
вести: вести
вестись: велась
весь: всей
включать: включало
включая: включая
вместо: вместо
внутренний: внутренняя
военный: военная, военно, военные, военный, военных
возможный: возможному
возраст: возраст
возрастать: возрастал
воинский: воинских, воинской
война: война, войне, войны
войско: войск, войска, войскам
ворошилов: ворошилова
восточный: восточной
восьмичасовой: восьмичасовой
враг: врага
время: время
всеобщий: всеобщей
второй: второй
вуз: вузов
выбрать: выбрало
выселение: выселение
высота: высоты
выход: выход
генеральный: генерального, генеральный
геополитический: геополитическое
германия: германии, германия
германский: германских, германской
гибкость: гибкости
главный: главный, главных
глафира: глафира
год: года, годов, году, годы, лет
город: города
господство: господства, господству
государственный: государственной, государственные, государственный
готовиться: готовилась
граница: границе, границы
дата: дата
два: два
день: день
дивизия: дивизий
дисциплина: дисциплина
длиться: длилась
до: до
достаточный: достаточного
другой: другие, других
европа: европе, европы
жизненный: жизненного
жуков: жуков
завершить: завершено
завершиться: завершившаяся
заключаться: заключалась
закон: закона
закрепление: закрепление
запад: запада
западноевропейский: западноевропейской
западный: западной, западном
запас: запасе, запасов, запасы
запрещаться: запрещался
затем: затем
захват: захват, захватом
захватить: захватить, захваченных
земля: землю
зерно: зерна
значимый: значимых
значительный: значительные
игоревич: игоревна
идеология: идеологию
из: из
избежать: избежать
известие: известия
изматывать: изматывая
изменение: изменения
иметь: имели
использование: использование
испытание: испытанием
исторический: исторический
история: истории, история
итог: итоге
июнь: июня
кавказский: кавказский
кадровый: кадровая, кадровой, кадровую, кадровые, кадровый
как: как
катастрофический: катастрофическим
кафедра: кафедра
киев: киев
ключевой: ключевые
командный: командного
командование: командование, командования
конечный: конечном
конфликт: конфликту
корпус: корпусов
коснуться: коснулись
который: которые, который, которых
красный: красной
крестьянский: крестьянской
крупный: крупными
культура: культуры
ленинград: ленинграда
линия: линию
литература: литературы
магистрант: магистрант
май: мая
малый: меньшими
малыхин: малыхин
март: марте
материально: материально
менее: менее
мера: меры
месяц: месяцев, месяцы
механизировать: механизированных
мешать: мешавшее
минск: минск
мировой: мировой, мировому
младший: младший
мобилизация: мобилизацию
мобилизоваться: мобилизоваться
модернизация: модернизация
молотов: молотова
москва: москвы
московский: московская
мощный: мощные
мощь: мощи
музей: музей
набатов: набатова
назначить: назначен
накануне: накануне
нанести: нанес
нападение: нападения
направление: направлении
нарком: наркомом
народ: народ
народный: народный
население: населения
наступление: наступление, наступления
наука: науки
научный: научный
нацизм: нацизмом
начало: начала, начало, началом
начальник: начальником
начать: начнут
начаться: начавшаяся, началась
неверно: неверно
неверный: неверное
неделя: неделя
недооценка: недооценка
неизбежный: неизбежны
нейтралитет: нейтралитет
немец: немцев, немцы
немецкий: немецкая, немецкого, немецкой
необходимость: необходимости
неправильный: неправильное
несколько: несколько
несмотря: несмотря
неудача: неудач
низкий: низкий
новость: новости
новый: нового, новых
нота: нотами
ноябрь: ноября
нужда: нужды
обескровливать: обескровливая
обмен: обмен
оборона: оборону, обороны
обращение: обращения
общественный: общественные
обязаться: обязались
ограниченный: ограниченными
одержать: одержали
один: одним, одной
однако: однако
оказаться: оказались
окружение: окружении
ольденбург: ольденбург
она: ее
онв: онв
они: их
опоздание: опоздание
опыт: опыт
осваиваться: осваивалось
освободить: освободив
основной: основные
особенно: особенно
ост: ост
остановить: остановив
от: от
ответственность: ответственность
отечественный: отечественная, отечественной
отличие: отличие
отсрочить: отсрочить
отступление: отступления
оценивание: оценивание
оценка: оценкам, оценки
ошибка: ошибок
ошибочно: ошибочно
пакт: пакт
первый: первом, первые, первый, первых
период: период
петербург: петербург
петербургский: петербургский
план: план, планам
планирование: планировании
победа: победу
повинность: повинности
подготовиться: подготовиться
подготовка: подготовка, подготовки, подготовку
поддерживать: поддерживаемых
поддержка: поддержке
позволить: позволит
политика: политика, политики, политику
политический: политические, политическим
полкан: полканов
полномасштабный: полномасштабную
положение: положение
польша: польши
попытка: попыткой
поражение: поражений, поражения, поражениям
порог: пороге
после: после
последствие: последствия
построение: построения
потенциал: потенциал
потеря: потери
почти: почти
поэтапно: поэтапно
правильный: правильной
пребывание: пребывание
предполагать: предполагало
предпринять: предпринятые
представление: представления
предусматривать: предусматривал, предусматривала
при: при
прибалтика: прибалтики
приближение: приближении
привести: привели, привело
приграничный: приграничных
призыв: призыва
прикрытие: прикрытия
примерно: примерно
принести: принесли
принцип: принцип
присоединение: присоединение
причина: причин, причинами, причины
проблема: проблем
провести: провести
прогул: прогул
продлиться: продлилось
продолжаться: продолжавшаяся
производство: производство
прорыв: прорывом
пространство: пространства
просчёт: просчеты
противник: противника
профессиональный: профессиональный
проходить: проходила
работа: работы
рабочий: рабочая, рабоче, рабочий
равный: равные
развивать: развивая
развитие: развитие
развёртывание: развертывание
разгром: разгрому
разделить: разделены
рассекать: рассекали
рассматриваться: рассматриваются
рассчитывать: рассчитывал, рассчитывала
расширение: расширение
регион: регион
рейх: рейха
репрессия: репрессии
ресурс: ресурс, ресурсов, ресурсы
реформировать: реформируя
решение: решение
риа: риа
риббентроп: риббентропа
рига: ригу
ркк: ркка
роль: роли, роль
россия: россии
ростов: ростова
руководство: руководство, руководством
русский: русской
рф: рф
рядом: рядом
самбекский: самбекские
самовольный: самовольный
самолёт: самолетов
самый: самых
санкт: санкт
свой: свою
сделать: сделало
северо: северо
семидневный: семидневная
сентябрь: сентября
серийный: серийное
серия: серию, серия
серьёзный: серьезных
сила: силами, силы
сконцентрировать: сконцентрировавшей
слишком: слишком
слово: слова
служба: службы
служить: служит
смоленск: смоленск
снизить: снижен
соблюдать: соблюдать
событие: событий, событиях
советский: советские, советский, советским, советских, советского, советское
соединение: соединений
создавать: создавая
создаваться: создавался
сопровождаться: сопровождались, сопровождалось
сосредоточение: сосредоточение
сосредоточить: сосредоточены
состав: состава
сотрудник: сотрудник
союз: союз, союза
список: список
справка: справка
сражение: сражений, сражениях
среди: среди
средний: средний
средство: средств
срок: срок, сроков
ссср: ссср
стать: стал, стала, стали, стало
статья: статье
столкнуться: столкнулась
страна: страна, страны
стратегический: стратегические, стратегическом
стратегия: стратегия
стремительно: стремительно
стремиться: стремилось
стремление: стремление
суметь: сумели
существенно: существенно
сыграть: сыграли
тактика: тактики
танк: танк
танковый: танковых
тем: тем
территория: территорий
технический: технических
технологический: технологические
тимошенко: тимошенко
титов: титова
только: только
трагический: трагических
третий: третьего
три: три
трудовой: трудовая, трудовую
турция: турцией
тщательный: тщательной
тяжёлый: тяжелейшим, тяжелые, тяжелых
увеличиваться: увеличивались
увеличить: увеличен, увеличило
уголовный: уголовная
угроза: угроз
удар: удар, удары
укрепление: укреплению
укреплять: укрепляя
укрепляться: укреплялась
университет: университет
уничтожение: уничтожении
уничтожить: уничтожить
уровень: уровень
урок: уроком
усилие: усилия
устаревший: устаревшие
уход: уход
уязвимый: уязвимыми
февраль: февраля
формат: формат
формирование: формирований
формироваться: формировались
фронт: фронта
хотя: хотя
часть: части
чернов: чернова
численность: численность
число: числа
что: что
штаб: штаб, штаба
щекатун: щекатунов
экономика: экономики
экономический: экономический, экономическое
электронный: электронный
это: это
этот: эти, этих
эшелон: эшелоне
юго: юго
январь: января
